"summonerName","summonerID","leaguePoints","wins","losses","total_matches","win_percentage"
"Zeyou","IYfKNiBm5e82jGaQtpBqeL-jJAjHlkoraE_B5VP_XxOUgYY",1,41,14,55,74.55
"Duo Abuse","oGz4dulqsi9cxT9h9JeuWRSvI4YbNZ6e28bDZimh7xBJ8p8",323,40,14,54,74.07
"MeiTou WangBa","iiFx3wWBUrC9hWpOpkYln9cFicjDd3j7pBzbqWZIfU4Lmw0",1,34,12,46,73.91
"twtv Frigault1","4tVRJvywOGFAxCna9IfS9IBDW090wK4ijPgKzXH9cHD0odnG_8sw7Jwf_g",0,59,22,81,72.84
"Yuriiiiiiii","lnm4DDRHxsPEUMrPuee-GOP8JlnJyM3HsLidSFSovN3FJLs",328,78,31,109,71.56
"Ai Qíng","VaIATDuJiH0i2CeggdY60FuX20op-koNeKacEU3yW_wksyY",182,54,22,76,71.05
"im a joke","mDK5f2Q5phzP1rUkei3sIyrIBKEAxbCR_hXVi2p1bxxIihA",203,78,32,110,70.91
"Rank 1 GeJu","MN9gYEA39-LyMBrfV8GxC4SfpFuRYNIPTuSbSlPWcnhtNQQZGycnh3p6rw",127,31,13,44,70.45
"中国","GP5hFa6nGpLd8J3ciJcDM36m7-oWW2DmK8aBlFfqYOAzAWFosOOT8IaCAQ",1,52,23,75,69.33
"Moretthugo","IfvuXeRjWUlRuHU7K6v0nVsnsYUV2Dlto4rkSkxPHkmH7sg",1,66,30,96,68.75
"Sugär Daddy","i75AYq6TnnOqRzJWfTqz4dMbG9lABvT81mnkQpegBVSNt7Y",1,66,30,96,68.75
"TSM FTX Maple","U7e9_Ov3XoTwvrZTl9Oh-I9k9I87OsRn3AnJ4hTTOjp__Yuu5Zle2oE3gA",321,83,38,121,68.60
"BestRivenSiChuan","yLDZNytJd9VdVzOcaXO-Nv5EUuhv7xp0J2Ii2Gpwka5TeTQ",221,30,14,44,68.18
"VX JustKalista","7mApQ4Lhh7tV_elvbOhJWaMRUN9ZW2rtcide2WWSixL2tQkMbSiDEqG31A",295,96,46,142,67.61
"Pou Tei Tou","x5CCtoNrtxpKjdW9ZM6MLZWi8MyBTWQabK8miom8GuLj_KQ",1,56,27,83,67.47
"Cant Be Stop","BuokAO9-2rtmWaPS0mWMfK1J4_TZETRN-rwDR-Patr59Gad8uKTDfFfkzA",129,118,57,175,67.43
"illus","DI7gNtQpt-bQioUfIWqoXnH2I76NJlLhNdY0GQ7g7O9YrvE",13,41,20,61,67.21
"Bushless Rengar","WH3lwATjV8G3Q6V3A80uYfbe2YZhf2th8WhOWE01NhFKjp61",0,49,24,73,67.12
"Iittle boss","M49ch8GULLOBd-mcBycrkLhzBH_P1vZLst3TZvQqIN5RLFY3LUc6vjdavA",100,59,29,88,67.05
"LEL EZ GAP","LzYJ1xXYTgU-_PCdOTNqgXa63WZfKewp6krn9T0-vfg6punSq-wbj8jogw",20,113,56,169,66.86
"IRELIA L9","UQ_VLK3Xq5gbAOXZFMr8nP4zWSW2qbbrbdEkAj32mpexujy5WboM6ej62Q",15,54,27,81,66.67
"OX1 LOVESONG","KVM0yRSNby2f-2KXkAetoYyL3INKsyTeyycfKsxbh9AZjWFkOileIYXQSA",215,72,36,108,66.67
"GG Array","h2zkkchkaQAR-nw5iht2iRErnmvH2nguF8fAmoPFRErDrjs",6,209,106,315,66.35
"dohwaji","AVEIgtwQSPv5WF_QNvbTQrd7xk1EWwhfQXc3djGhl60OH1k",1,67,34,101,66.34
"Chud The Chad","A_6DAnTO7YkuYHn-OzAIx4WmkTksU-z6iRE3g0-lkvSudS8",1,51,26,77,66.23
"4537","HOIKCcGS2k6M8IlA3atCd5PyFV_F0CvgRcVvcQ0a61Kwjc9m",133,74,38,112,66.07
"wo hen fang","VJltHI8CcHsLp1SLzqxo-5fUwgsvgQSl16gTzJqJp7hAohg",181,37,19,56,66.07
"elo akbar ","PTiBxt7F-r2ikGLHgXFpULF9sueMt_RkIHbZUT982prThQyRLbMWabccaA",38,62,32,94,65.96
"Nànacat","gXqqIK1UlU0KSzQNUfI1_vqQffpJyaTXKSTg6PZO_K4TBJc",1,29,15,44,65.91
"in2yoü ","SQheZyifnrJLC9E-9rMOvMmY-hHnFQviFLTy7mzgscqjkuc_OIA9Z1zDwQ",357,84,44,128,65.63
"vuvlkwu","q8CNYPjIOE8JmOBFd5pc2reuhmZLbbFywZseHtg2WznTq8Sh4vT-BZipIw",101,72,38,110,65.45
"I4std4nceDF","IWfMpkNS1djwy2Hm4yGWtPdvImhKEVR5dTGS79cf6Vf063Tr",313,47,25,72,65.28
"ale1147","VW4ije3NqQzunRlpSq5oGWeqSbP-xd0KeDlcwak0m0coQfp5WglFAlc9Xw",1,75,40,115,65.22
"Nian","Uman1MM7A5KL_He9__L6a3wnEkvK9BuzoRJHAwusAA35aSI",0,52,28,80,65.00
"Just Kalista NA","zx4z6EUeLyym59-4Xd4Jfax2mNUUEUhH_IdnjnktnNu4sEdJ06ufyNyIGg",1,39,21,60,65.00
"Bahm","Lmx9bJ8aXqzZVn90v764fPZyylG-E3Csjrx8dJavC4pmWBJD8Zj9KV5bSQ",128,63,34,97,64.95
"Cidy","VsvxzlzrzUy5KizcEkVTtbqZLsg6MKzfVmIpgOKvQZ3hfgY",20,231,125,356,64.89
"Cindybell","CKiLWFKUHhH_94q3euB-i9i7dGry2FcHnkXIaqkIpXN756s",189,142,77,219,64.84
"QlGuaiDeShangDan","QqFzVgFGeiOseQHM3p_5NMYzkqnIBmZvCRBEWobBOtdn5DE",1,129,70,199,64.82
"kaisa2","bjxfJ5BJDlBu7ObU2ELPWkVVZk_FgsqDQsw2zJz_tOqdkhb6BB3IJPJSFg",83,57,31,88,64.77
"angel saige","LbNitSDjk30OPPp73mwT6iXi8-9Hk1YkyRuZQy7CMWCqX9w",55,148,81,229,64.63
"GGFF20","SdLsgUuCURRbLP2Y8rQaCRj9904C7jg3zg05D550Y6bxycw",1,42,23,65,64.62
"tkhjjhg","ox0OenQRdqcl9MmXmGLQV8TuM2SUbQdooaCBu1i9P5HWSHyTK7PohBelzA",221,84,46,130,64.62
"Spookingz","7v5UdGlCtDEn-1sBRD7jBp9sAMGLlZGoRQIfbslDOoDRK4c",131,124,68,192,64.58
"Pinkpepsi","P_-P297zsNTrDXqf1HbxZNWhvZugWGM1It_2668x4FEAzRU",1,96,53,149,64.43
"Xyzzzz","DIIxSo1IFYNd69_TZiYSaOBGt7Ux-yy7QpIsC9Qy7X7hnYg",146,47,26,73,64.38
"OG Fuzi","W-vrmgO5fh3uR94SmSYAq_IIQ-QwtoW5fQ7S9dya-2ElhRw",466,202,112,314,64.33
"Sc2 Zerg GM","FTdyuY5rSZCruJb4twZAXs90wGEqVENzAfJ_tmar01qLYrg_tcAMbtSkPw",88,155,86,241,64.32
"Pigcat","b7AuJOdrK-7YtsajVJpjimJYdl_1gBf2e8tXTfHfnYNQYH8",255,66,37,103,64.08
"Setz","GJGbKTm9eU3vnmwUFkgL3YzoQwPD0f-lD5Va3RYDeBShfHM",284,66,37,103,64.08
"your dreams","z0sv9D6bQFRnk7WF-lxEVVVq9dtwYntxaUTV55wTYk7DOZUFZZitFNAbig",40,57,32,89,64.04
"K1ll mys3lf s00n","16nQYaDTFEJWdFIRDcJNGoVsh-bahaP4BkFfUCPZU2THwZoo",246,99,56,155,63.87
"4MEBA","eaoCtU7APlmEdP19SdNvtr7AGVTpUPvudTvutPQB0h7ghYjA6JA49g_xvA",216,83,47,130,63.85
"Leakiss","KazxmO8ODzxSjW7AM6g4ojir5OdMu6cGSEJ5HpQQHiuHBmHNPw-oY2f2Wg",82,118,67,185,63.78
"General Thragg","g8TgnAkEiLhsDzAMmnO6SM4yfi8anbFG07-Hma1bqdOxJphD25XnvHgXoQ",0,51,29,80,63.75
"RiMuTuYuan","m6ZAUQ-JLC4HWfmhwwnmOy9jjMj0yhGpzo1945Lhtpm0GChMdMaQQYNTGw",50,79,45,124,63.71
"kl4mzalot","bUm5jI9l7bwEYI9I3CYHUfcCSJ8GAveaG-mdCTGeOgFXklI",353,99,57,156,63.46
"kevegc","oXE7UqBZp3aZe6TVo5r0Ed7Xi3v0saG61v4yB5feKrLqkFaO",1,59,34,93,63.44
"mınataur","Fco-jcvhvDnUVNKtWeno1-C2B5FTDXu2VrMf4rjLQJQyirg",61,128,74,202,63.37
"ßeards","4cSxOPEeeuaRXbZJjwchQ95P4nPo0-iK_CODHCq5xvb3MpRmc9axvVYztg",1,192,111,303,63.37
"Qween Bee","EJl_nRovJTfw3RL7IJNg66nAUzkb4ZaVb8PggQa7WeVLMWw_",128,74,43,117,63.25
"BillyBlopJew","FhU1tVYhEU1CKD1D4PRgJ-OJjGW9NKJOry_ji5wBDH1dDytJ",453,97,57,154,62.99
"Pogba1","2QVINL8ec64I-oY6gw_p8L84X7QbNHrWiJakbPTdLyX7yL4",175,68,40,108,62.96
"TSM PubeSlayer","vKTjxmA-He_8vU4-werl5gRZSGnGzvgzrl7VRtjRQwvmpCbBbxcXLOw93A",36,56,33,89,62.92
"onnou1","DiMkXtL9qc7X5iEYL7POd6F_POgcenilCy3bNgcZ31WHj6eLvrcQec9yAA",45,61,36,97,62.89
"ollaU","WW3RwcUwg6S6KHD7Ue2DeDRXl-kQSJ35Cha7pNkuZZrMtAn8vG1Hg9z5wg",1,69,41,110,62.73
"Blown Away","ApBvnlFuwfua6wuKiwEc9_7y_3gD5Ouj9hodoKsU1LEFX68",317,222,132,354,62.71
"Night Rose Vayne","viSjLCdFjFoh0C2JYA9-XyOws0Ibx7fytBFiD0DnAofgq2s",153,52,31,83,62.65
"Ancestor","AzlmJHoIIQ3Gcxx1odZs92p3GTtHbNebN3FR86Zida8CAU7934lmlMLNcQ",425,97,58,155,62.58
"snowcard simp","sPoTqYLpFe0_GbIN1xo6M19IIpQdXI1V_a4t7E_iMXn2070f",302,70,42,112,62.50
"PokePoke1","XAaTbjLxmOErskOP-55UsLJJslxpX8iIZavcSNlaZRyVqcQ",370,125,75,200,62.50
"GALI is Artist","075DnU0i6BTUGb9Mkz_aWV_Ibvxb_CNLg5m2albcCsUtY33D",90,95,57,152,62.50
"ad diff","gUNkftlyfaO0gke7pVj4mSsts-LaOMWCTZNzII-ReDTCJZO7",107,65,39,104,62.50
"Wump","VKoj1QU-HCv3B-q8ErsUC-hLrDfzkUg5plQxq6lG79TlS-8",122,171,103,274,62.41
"Buff Lux","TR0KN5xRXLy3wg-cga2700uAZNkWFNtKp_bxvIVE8FGNlCV7z-tafM3HOA",216,88,53,141,62.41
"Stalling","nQIj-Av4fsEnqHKZ5GHoHR5zxucpejoXPYpUdjb-R-hQid63",49,86,52,138,62.32
"Riot Koyuncu","s0UsqkwnGeWVFWUUTVsWJogaL5SyUR9ZT9q-O1JmxJPpJXs",298,43,26,69,62.32
"PirateHunterZori","0_5ImAPtiR0KIXpoPSgJFxr17kuSDblD-tT0pTb2QSBQSsg",96,81,49,130,62.31
"sebas","g6fPC13jhIuNGoujeuSTMHA2diImUhQdKSCLRnr2VP6tVAk",118,104,63,167,62.28
"451asda5r","6uvODRHC9D1lZvVh76qvwGBn7rhP1PHV6N6-xL--3wwlHAotGA5LJsWHNg",114,99,60,159,62.26
"Li Hai Xiao Zi","Cug6QRCyf4pAdKxAb1M0ATT_g-rWk60E9e66bY3uRILSQoM",165,186,113,299,62.21
"Johhny Joestar","b_yozV3U8KzkGua-jb-IKkYtRUAhD9WBNjUl8_ma4ZIrQeNkiBuTCCi1DQ",97,79,48,127,62.20
"buff weak champ","0OEuuk-ZNFgLL-x_QZ8ypE7KWprggiNgOPiVB-dfxYhZDpX00-wg3BDOpw",140,166,101,267,62.17
"SJHAND10","lvgXW1hxZuQ0aC0yVBR6pSh-brViFP9Fbv2ZDqItTzaK4DBOmOx4HvdkGg",20,92,56,148,62.16
"1999 10 27","6JQ3el30AQrJXksl44i0AkiR0rayOixH-hOw28ezwYte3bbuu6qPkqGwLA",168,64,39,103,62.14
"Lucento","SOfpPBygpdDu_f4cHlcc1zq6r90RCV3oBLGuVu-wXUvNnvYhsNxbgkj2pg",242,105,64,169,62.13
"Veporgou","snGFKk-uhTJTvBbh-MhtwPMFe33OUfuwT9uk6lpjItZlJwUl5Y9bUznjbw",39,77,47,124,62.10
"fIower tower","QtKZpYD3OhbuxjULaEAIgA4pNmnZnrdtaqo90pnqgHgiMgBcvk2OOxKInA",158,108,66,174,62.07
"Ph Vu Khanh Toan","EYBbfhsHuVS8_BL5Cg8zBBKqKQwYGplgPkpVomEGbT6ki2gfzPB3K9lm8g",1,72,44,116,62.07
"Dragrlord","W519ww_nqAuuhajA7YTytCbIwnbtUG8gpIBPHpt9MIdmuw4",72,80,49,129,62.02
"XCM1","P-63lBRxVdWxX_bjXkkmeloF7NVoZgDvOARJtBcaOzBRYGH4cJLTQ5xqpg",54,62,38,100,62.00
"Gr0ß Meister","nv6dqGVnteBQ3uFiRvXj3eVX6yxsmBb6NLm0IDfsJlLenD4fo6Q1xbCmxw",200,83,51,134,61.94
"ybsılver","f5e6rD9EbpgqQkBDpqczXq1yRhYtrLnFpekqhJ_-ZDBw-1QA",305,231,142,373,61.93
"Lèft or Right","ti_EEgKXqHwCsmyuJGlnABlf5JRd_V2ZKucmPccmBn69hEI",210,39,24,63,61.90
"Fleuber Burbler","KAiwlnYmiePiDCiuvfvdbnqcolXZEWxihHwHYFTMoA3Yl6U",1,39,24,63,61.90
"beatopia1","r3gaPh2JOhdkZjJLwgRsEhIkkBNVRrRQjIiOQCSE06RgvOYj6EU1htsg_g",27,91,56,147,61.90
"no draven day 2","5GSRX3eWJEnreTy-vExyGLuGwO7iG4A_g_byf17Ues8IBhVx72yVirI_SQ",1,86,53,139,61.87
"UCSD Superior1","R8Z3cC-_E7bXn0ZowDkoYamVgSRw0pRCUR8VFqkGweIulckQwIT7fBy5hA",68,73,45,118,61.86
"7Wylly7","1x0gIe38UORfB5eWwAZKUUG8-1TOtgIIdQ3xHym-_-Aqxl4",1,94,58,152,61.84
"MAMBA MENTALITY","qAADEaQkNPKorsRCOhWKCzDw9sZPHrouKugw1xwMrukQLoK4xWdEi93DIw",372,55,34,89,61.80
"TS SI TK FVEY","mhg0o2-Hmv0uC73nKjYEohWzRBZdXfwfsPfVmncMBPYlTG0OLRBUGTlciw",0,55,34,89,61.80
"Secondly","kWleWXYRok02P70AbvUkiOYtAxAeoFmPgwQowWdgbR_ZR846wIvRrHaJ1A",52,63,39,102,61.76
"RagdoIl","N5IX0cBg0yDXrUplooQTZHTHl7mNqvjrCAfQdpgrs2Z7dyGL",1,71,44,115,61.74
"Gladgame","DLej8aCHJOuZm95RJWW8PZvzgtfFzySOG3JqCGijucr-fj3F",375,71,44,115,61.74
"Nivupovu","ctWYBfPeb9yXlBdrvQbD5X_aaqHT6avrRyfg3lTx29wR20gwrVk7fsrVFQ",387,100,62,162,61.73
"NATHANlEL B","OMrGL8h1ag9iy8Vp6Q-J-YDnUm6cGz_kL8imnMI-8BAIRNNh",1,32,20,52,61.54
"TTV lolBeginning","13vqbH6BEUbfVFYtVcFkj_R5qhzVOMldIb8WD1QGWqWUpNc",1,131,82,213,61.50
"Local","ticxcF1q912Y5jGAXxlMWO1WP36Cy50Hp7Yzh1m43CsLfeY",4,150,94,244,61.48
"Lucidiums","wJRXmDI-NxWcUjLXkiQ2lpBBjCNvwcK-qieStCstM86DKVL7",77,75,47,122,61.48
"Sołitaire","bardljQrRqle_KMGkZcp6mZasYrE2eTd1pcHFtYqi5mJA9tp",308,75,47,122,61.48
"Bowl of Bap","YvWUSbTJK9lxtRficWh-7n3rTVmtG_2te-6UPHl_0wAl2QU",62,83,52,135,61.48
"Kururi Futamaru","fn5r7kL6oc_Lb9wYrYxgNbjL3kmBIIVW9ExzVC8zPoLXZwjn5QewBDQhbw",284,51,32,83,61.45
"using spells op","_dm6_xMQPhKTttG1YRU8qr35BXe9khRlnYMCb1ENBklPxAr3SgR28yC9Vw",2,94,59,153,61.44
"Volphins","ByLl6gn2_fv5xrO-58glm1P2zHMxys1YEoqT1pDKLgJ9BmM",117,70,44,114,61.40
"hhveye","TgagYpNarXxzFvHJulOPNcppwUsVGvWrw881OV996WW55n7zOjfPdguCkQ",427,213,134,347,61.38
"lf good girl","oGzlQMMijOpjtkUQdfozcl72mUUgsxGNPd_zJpDyvnO19Og",421,178,112,290,61.38
"Dunkłe","0KRwKVYY2tiKEiwC6VliBUuxs0vzcg5RQ2hQyWVD6PztBLs",53,57,36,93,61.29
"Magilaho","YUFzFEcxEEdygePQc51rB2syzgj8kUtD_cuDlBkmnqW4P4LWhz29uinW_g",103,76,48,124,61.29
"Goat irl","1hf6ctqR5ECgEnxqPABlGdIk1cagiuouF2eh9Wo5__Ld5JE",203,114,72,186,61.29
"Sizzzle","0KXzPnow7KtVAAIZdjCeHlRD1mOvJ1E-eZ0r4ww_kciqnp0",30,133,84,217,61.29
"Nanners owo","auXYfCWOmeDcBorsAt0qqQ_cI22AV7XizpEH2Y_ObR449xE",0,33,21,54,61.11
"Mozyagi","0bpVTrQ9iQzz7O8M_a307_Ek8vyh_wg0MR-dMXPErLLbje7XIAssCfIA9A",208,124,79,203,61.08
"Toothierosprey3","m-HEvC6-hoUEA02iYDfuv5leyYm3IFai9oqek4oMtw4M3i0",1,127,81,208,61.06
"meant for you","RMiTUu0XjiLYSDytfRQBnLoKtcx0Vb7zi0DN9zR9Bg7d4qvj",36,58,37,95,61.05
"GenjisLastBreath","ga-vHwcalUgqhA47otF3kBDiHGWdCTQsYEgcpFI4Y3QoP_A",439,58,37,95,61.05
"IllllIllIllIlI","ZQt-9t8jFzxNBI_Rn2wJzRSB-KBtmwnlRDI0Xby2Kgz_vf0",345,191,122,313,61.02
"Zyra owo","FcYkaePf-tInTW0Qgq78JdONcEpbbIhMK3x-hmt2zZ39lUM",108,133,85,218,61.01
"pepen","fJcrWbNEg5a9s2LkHdPsLC4eoGjIoqJsRgGDl4FrXN_yi1SJ",231,89,57,146,60.96
"TES JackeyLove 8","VUS7nHUxSbbqrndQv21t_3QUoGCshmze-xBLFO7Oa-WqGwYh",70,39,25,64,60.94
"Sheirskel","ChmDLvhaQoJis7QDNs6xl1nUTPAqkOAFPRhgAKL5OhFWaPhUlkgwKGJ8sg",35,106,68,174,60.92
"Lost 1n Walmart","vLuqS8LBUIVxZc8GtjGwryTbMI-lhemn4pWZ2_enn54pRNY",341,134,86,220,60.91
"gaming girl","KdRVyNLe1HMYJGL5vjnmZLhpVzHMSg-hhFBvI3_uF2snx4M",373,70,45,115,60.87
"CarIos","Qk25s2b_qaEAR9UtIQwKBxPRWLIYIt3ZE4uITOGzEAd7pT0",286,73,47,120,60.83
"AP0CALYPSE XDD","QsznuSJBqH1D-Q33cdx0GF1qKBlfvybOAT1KvkJZbvmKdoyM-L9jRKIggg",0,45,29,74,60.81
"EBIC GAMER","_m81DdmFlc-c80OFxx8yT-MAe3PfrQk5WN-1Ns57a38VNnU",46,68,44,112,60.71
"kissies","9Hp2SfBs93HQsK8RNgicIy8X-QhB8oe7OhUlHacUEZr-AcGx",47,111,72,183,60.66
"Dios Kai Parker","6nkzNAlRFICPFuGSNjcVlVL5dLky3X14CatFVtryk2OotWxBX2eZTXuv7Q",36,111,72,183,60.66
"Twice Rosemary","4fpgUtUoNb60tb6o7WhWECVSEtBP9TEvA0rmoBfJCxXb928",0,77,50,127,60.63
"TexZrIs","1dUj_5WmV6pbT1bnKGxLUyVG3KLvCLDEdun9okbDIAi5XBE",31,117,76,193,60.62
"YongGan NiNi","ey2EDUR0C6iVMc9Km3Kg6h_6KAhw3g11XEGAUwbMuByLWqM",1,117,76,193,60.62
"r3dv1per","QSQn7QG_otfABYwoAGfC7VUsHUuCxYprcL_iW6_Jbb1sbKQ",202,80,52,132,60.61
"fantabeverage","VREzS-yyg5STsgf7KA2nqabcXq1Zz8uHrsluvy_U4ivnrMI",0,86,56,142,60.56
"Dragowski III","LG9iRtgJt7tORUoepeVoJOiXoFbIAA5f6OPl1JL3wUwPWKja7_8NKUHcmg",83,66,43,109,60.55
"1.24E+15","_YtytbvCUisxWksUrBwHkAPp2-ukeSG8FnvBcNksHy4KThnatWo1r5XYzg",222,92,60,152,60.53
"Dongzhi","3M0FnMlF6KgVPSTU1yLvm132znfZPOfga7FfKON1GY8bFr1n",201,95,62,157,60.51
"ina y aní","b4SJB4uBpjYHheWqDqqUrsuyEpykxMeoA3oFfW5K46zgvm-uBGXYsDrHsA",143,101,66,167,60.48
"he7","5d6O-dvDjodYv_OfiDNpNsV4hPcRNZRahDvKn_rWBPdh-1w",111,182,119,301,60.47
"fire emblem","39NTBH4URZmY8pxvJbuFy3MyMCij1y8dZWceSmdCBrDflYM",70,26,17,43,60.47
"ihwcsq","srsYlLTdxkSd3MB6JPnWTMTtZQLSveHd8HG6MZvTU-o9jeGLCxg-8TM01A",26,81,53,134,60.45
"Zëuspuncher","rysVo0fKHfChTiYrVDdm7QSnXVxMrZERwy4KsG3uuyENPzo7P9ofgqxkmg",1,110,72,182,60.44
"ruvhosh","tyzWnGUAvHiz5sjY3K6F6iYqa8xoZBVxQEPTTMo1elr0vw4VVXjqQXpvxQ",421,58,38,96,60.42
"onvucwb","DFfipz1vD4CynlwLrRVf5iSfsnq8qmGJtY09YAoLPjapiF8jQgloQ6gacQ",457,119,78,197,60.41
"Unsound","RZpikkjX3Atqtzae3HBYS-5hMDc_YGhUZ4MLAywtMiG-uUFb5O0_y31jBQ",0,61,40,101,60.40
"1234qweq","x8ILuIb0Tb99IKG_4NS3NpRCzeohDyjd6Lf8_TIKrHGsA_r5",380,64,42,106,60.38
"Eidson","uPcBUJqYT49k7adE92XbwMgYRnQo13L1DUbI6EZBfiIj-7w",275,91,60,151,60.26
"Very Lonely","BWP1MJM7-MFgI-XLWRtUjjwUbIvu0SexdiCbkV_SxX-hWS0cpHw_PsesUg",42,91,60,151,60.26
"lefdd","tIHY7T6jIW9TxpKxnSioY4RxKEMZaagf8dNwKetKx9ZYrOlHR29YNMXSqQ",1,91,60,151,60.26
"BruceWayneBTM","oVpat5GDcMAiTlyVbHsO1M7tuOCV1ux1J2b9QUVOOE7MooQ",1,53,35,88,60.23
"NOT CHALL BTW","y8wc8QI_70ptAGvYW4DiMUGDwpt148zc-Ckuv1GAlFU3Tqfh",168,112,74,186,60.22
"Mønkeÿ","UOploc9CCY9U6XahAU4Mdfk0Fp__Iedt00MuCBpvtMD7Srw",116,59,39,98,60.20
"moimmeg700","ixR6TLCHAxW_BMCKPKzBc919iBbvKLiGvPzlgXPCfwWEnzACVlowHGeBXw",41,124,82,206,60.19
"Lia desu","FQ6GTYHzq1N8S17FyiL1wshCsTHKZfLwShRg7D9fW_xPozUP",0,178,118,296,60.14
"Krës","SZUJRsxXmy8n9MiG3OF2_RDIx23shXJckkQB5BHG1pdCXo4",1,98,65,163,60.12
"Caikness","1AYhPr17TLp3_YRyS8DTS7jK7lrXXMEyrQXFRD0UgjfsC_Q",384,220,146,366,60.11
"Kaquanrax","b-MJVZuYC8LqAuYuW68lz_Bz_rrTEnmMibdgqlkMZx2dOLhedrb_2ens6A",0,146,97,243,60.08
"Ilumiss","8f6_93W_ZDu8t8dUr2XWchF5fGhibw0iP0KAkcPe9_pJy-Nq",45,179,119,298,60.07
"Im TianTian","9rbv5XBh9tpRL-Bm4Az5uretuI6gnnjZhyxCZGG-6ltkxKw",76,60,40,100,60.00
"HARDFIST 1","KmNBIFDgHXPCUcODi1LMebvdjPlzK1EHgPLLQCqP-VwTVFU",0,48,32,80,60.00
"f0rk 0r sp00n","XwhZ__CfW2hliy419HwhWuNJmebD9EHEUs_-4rMSHbDfvvM7",111,36,24,60,60.00
"Nami in heat","6f6MWhlkKsYU2l8kTR51TyZZlFrZLa7bCZKBSX1oqnEGkuo",135,45,30,75,60.00
"hiding from life","BhnuJZhw9IduMwMuU6udq2PgZ772zwJIYRAr6uaZ7AFCT1iXlh2WtmZYJQ",13,102,68,170,60.00
"Day Without Her","DCeqR6j_7lrfsZ4kBDecVh5abyDF6iXEzB5cfluaW3t3Svc",142,175,117,292,59.93
"NomadicBoulder","k6Vk7RQ7cj4vSBinZvVC7-6D_382eeTaqT-WU8FMojHoAw5T",271,142,95,237,59.92
"sjhand06","ki_CYWOXQHqLYsh0t6KjxEwa4qfrhepYnxHfSroV_P7VnTVb3YzgMtYvEQ",236,121,81,202,59.90
"GALi o3o","CxmGSgs_4pMTm-XTZ3gZu8lXjAXHai44uopkAmiIi4uEMULX",122,185,124,309,59.87
"Jmaks","S3F87zL04ltS209FNQOJ48wOn89vBMHTb_4Xd2M2bmSDbAaStINgS7PS0g",53,85,57,142,59.86
"MiniMelon","51KNgo890AFLr-1IZmjRsbOeNs-rLjnwH_HOr26OmCv7Mrw",177,161,108,269,59.85
"Flybec","YDahjzj4X2VaO1IC1Iw-miripICN8JONIDO89-y5AksMU1k",211,76,51,127,59.84
"Z0D0","ZudZ7nAH0hTy_2P2w82yTIW64LczFnlDgaBz4siy06NynE4",210,213,143,356,59.83
"Mr Azonto","SVVwGnDifYBhD8cizPiWWCO0Hx9VPJOwXYiF_Dt3YFpXzM8fdWXJLEt6gw",14,61,41,102,59.80
"mid88","CdKJv43Rp-WycnHXrxDiNFEla9IoJ7USXSbU1ljq0q4EHzzTHEJcUtG2Ew",150,98,66,164,59.76
"The Hope For NA","uW0zFsiLNYZT4fAl6_TDo5ZtuDfiw3vg9ZSWZnCZyz1kbZmHkKkBR4NRpg",54,141,95,236,59.75
"Biological Woman","7mI-38IJpdYR5-z-JNWAWARv27ngRGLQGMnA_2VEanSTZGyD",38,175,118,293,59.73
"yonwmj","PoCQ9TQpHsYTwGfHtmu8cwqoLGZSy4C9AGoI9oOZPZfMNWnpKKlQ2NDQjg",16,120,81,201,59.70
"Mufat Carlsen","Vw0QrvUQQsChGQdzTjVmwJK0_dnUKKYkY9xheq7nFU7Bpb8",332,117,79,196,59.69
"Sakuràjima Mai","a8fH7jrzd2Zt59NpFIrnxyrI7sK2sY6h3jdte6j1Uw4jTMs",1,111,75,186,59.68
"FireMagey","6lDxwpXYqyAiY4T7TX83OUY6vkoMlyAZcleEC3A8MMLqtTY",16,136,92,228,59.65
"Tilted By Jake","1PTI7IJGlfQF68qCtK-LYD-pAH7mkN7kd8qvq7EMUAPe-quIZpKEXdZbsA",21,65,44,109,59.63
"Johnny Fast","fsoUYUeLG2T-ZG6VTxEMC-wuzygEitj683-F9yy0zP8LNgoYDfrdZ4-0YQ",336,93,63,156,59.62
"furok","b6TD0d2hHyP04Fx8fPChhLJKKMPdX2ppGbFpgk6U1QJ5XpV-ngqCp13bBA",235,124,84,208,59.62
"Metaphor","IEhahMl-NBjqMmb0vAzGiIV9HcGeG724RQ_LToiWagdkLa4",292,59,40,99,59.60
"gnylhbo","pSEgOVAjZ9YABKrtr5XkovPX6nJGYfA0E25UjoAa15GxUNTp7BH28HpNLA",127,146,99,245,59.59
"I Am Conquest","eN3NN78oUH2uRCOhRIKqkM6mxqhZWcWiowVFvDu7dNOWKjzQ66lYqPlU2g",381,382,259,641,59.59
"Stove The Great","0klZd0Ekja42VSQVzRLMx2p8Syt4u0_zYk3s9ElUNVGQ",1,28,19,47,59.57
"Sandwitch0","KOiafuXhGBe0XHIFrBk9NGe9MJb1Bxwlh7grLwaZzvkE260",329,81,55,136,59.56
"JustAN00b","v8P8lKqyCgxkvCERl-TPJKDH9ivZ_k2rwiFcozyELp1WlHY",104,53,36,89,59.55
"PW jiahaoyou","A3YJbEVoc8JMZtucod0g7sGj2t8tJMmGLqDXWuWcc0VvulY",385,209,142,351,59.54
"Xer","lJr5_VM0d2qWyTy1p1y6KcV14fFATV4V4hfsGebpb8EPq45J",30,50,34,84,59.52
"Yue","_9_NSXzb1kp_DkQRFc4XsfYsStx8-eNf4RJFoHM64srm21U",42,25,17,42,59.52
"MistProdigy","-XiX7Wg--5rnQMhP315U5e27okjURixDY0cNBDgPk_B9AqA",1,97,66,163,59.51
"Kumokichi","Uxez8wgkec1qc9R00FWWRaTlvZJEAla2k_hrf5AABP0eMFM",20,97,66,163,59.51
"Chijaii","FEHxFXH0I3ULM7AASvduWKhED-ULhKmDUL6bBb8MaQXRDh8",36,129,88,217,59.45
"darkshadowspirit","APAM-MBbN8YnJE1nMF8TKeSI-eEhwIuGKM0DRObrCvRDwkQ",1,107,73,180,59.44
"Maitienie","pquFuchON1J5_JjQkD4CyyjEqR75ALtXlZnd9OYOUhwnIa-d6jlvbhQT_A",317,107,73,180,59.44
"EDGlittlestory","bgRs7oA7PjyfroGB60luJQLtuOyy0dNjHq3wGxcqBOE-zArmmNM4Con1VQ",90,126,86,212,59.43
"Jamb","YPEp82gDEpcOJ_y9fHzUA5TTiP4IGXuUGynYpfd53h4J1LmAhD4i6PUkjA",202,123,84,207,59.42
"Plz No Ganks","jw4-BrbstBlxqZPvsvimnY7Ym-Z4LLm3tIdI_be2HIh4M8kw",161,136,93,229,59.39
"QuinnAD","phF0o3VRwRdAfO5Rvh0o4QJmiSqz7LxXByE8KWq4rrtx7a8",218,38,26,64,59.38
"Wolverines","4JyU4jGWlbNzg91WKdyeq-JFrgEH91NxeTX67Mq6ciDbB9A",370,114,78,192,59.38
"Kanbi Nè","pFHM1kTrDOcrDblWs0luiH2W7zShGPre9q1rYBAj4B536tB1",1,111,76,187,59.36
"Gu shou li hua","MMwkAl5gl94uz-sCy5XRiNMjL9yIjcUsahw8Q2GflKdf3BL6",143,73,50,123,59.35
"Zazzychenko","ygbJCNkIiowFRg1o9aDqhqKd61O1RHfQfMuI8303AZIl0Wn29d1X29d6Vg",1,83,57,140,59.29
"Blettedva","_q7ybmEEFStvL8CLk8Luw1E8ZkQz0GuQcAQJc8gzUNhCUrm6ervvmzKE9g",26,96,66,162,59.26
"T P zs","HtS-oZuhRqv07ckuWRdZMxrtJyL3NRlt0AqYE7Mps7V6Se4",1,32,22,54,59.26
"gamer kitten","Y82UwNJRLu1k8eTfp908Lq1Az_aMJOdvPLx2_JGu_0-cBC7mTGzxwGj1lA",0,141,97,238,59.24
"FMJayce","yM_7nCBvX7DdalPSx94uwEAW1pkOpPjbwX5k_xfB-LwP9jY",1,125,86,211,59.24
"OGC PikaPika","9erEZsJguZiLYYHZT49OVvJcjViNpGREZZOm7nVtsAlrQqI",107,45,31,76,59.21
"PaiPaiKe","BvexIRbZSuZl0XUpk7s2E2d_-UUwQMe4ryJqQ4oCBCbJ1rA",89,209,144,353,59.21
"Zacster","USYRZLdv3UIyH6WoAi8zY0SZ0iCfxnU1gYUqIX7XRlod3EU",36,74,51,125,59.20
"The Night Lord","YQQYPJsZTmn-UyXqNfzzD_2dOf9CgoeAllbqOIj3qiWFQ_ixzNEZi5zRxw",65,103,71,174,59.20
"Refill","mkE9gbjRkV3pKnKENc-J2Ay-3rlkY-C8lnRR5XP39qxEGnM",61,100,69,169,59.17
"movetotheplay123","uhqYUR-nuV_3qkgnbmKTK51ZEkZM1TIpMmKRYmNfTqMB2RbU-M4wpQfzcg",121,94,65,159,59.12
"vinni the pooh","nwIFy_BLkAyO-VhganLNEjK3v9d1pfWf_sjy7ytGmVaQam8",40,81,56,137,59.12
"dingleberry bob","XMtLvQwYAH1KiWQlJBd5pW_Uo4WHI_QoXOj65o517eKtfFnn",198,91,63,154,59.09
"Negativity","BtMNFgLOoSpUlZAWmpDlZYla7kyfyAJIylthZRzIkUQw7vs",1,26,18,44,59.09
"Predator27","eoc_drBbxrbddRCMMGYQogZOBnANMBDXU-LnP8J7l_Aa",465,78,54,132,59.09
"eolle","yoowX01QV3ouVTmEBXV4EWLc5g0aZcSBJmF-Pfu2nKaymZblou1prOgICQ",95,114,79,193,59.07
"whitewash78","FFOQ9j4HD65Mht9huuNLtBJH-2j1nKxW6G0NCnFXqneTk-4",129,134,93,227,59.03
"TavernDrunk","UOS6I6CaoN2jZB8E0rZQzBdooe7DHd2Huz1ou63mLD9mwHE",246,82,57,139,58.99
"Aug 13th 2000","K_eqYH6lzgi90tS1EFpHAyfmJlsKzAtccLhYyflkle00sbHa",1,128,89,217,58.99
"Layne StaIey","TLEYYRGuge87Ueahqt1uEP64GtFBcPSxrkvbvtQ51g-1fTDW6l-FrWjEww",121,82,57,139,58.99
"IVY LEAGUE CHAD","nYzBGYbyJ5EsKo2LN5mPxjKwCud19LOr4452rP8kVlQP-Xc",209,233,162,395,58.99
"PC Seir","dYcOHTHFN--ErzQKyW-vgTSLOMPQx5D47QKRUuzzCzyKz9I",1,102,71,173,58.96
"FULL OF REGRET","BlPFT3jtcUuzQQMwAkmjgamAbnWdro2X4UEdWQtKAKzAmrw",209,79,55,134,58.96
"SaskioLoL TTTV","Cyhf-6K-_mTPgJM8jGKSw0jl3oRMQ_wNcG9tn_zX4iEJ-FE",296,148,103,251,58.96
"iDexter","U2BuXal0UK7Mc9DMwp_NsAOC0Qk8k3PIf4Q_8AoNqfFVICM",11,56,39,95,58.95
"Kp Ayou","_wPnXzwFE3b4LKBfg5LppWM4M-nHWTl7ra_IPORZfAp9pzc",0,122,85,207,58.94
"kknuy","Tyxn3GZsvUz6Au8Lblp-zkM6NHaYkvjCTWZWuotwG53q3VhbfI6HTe8GXg",154,162,113,275,58.91
"Rampage Sakura","EiWsrD9xclc-rtQCg6eSOrrNlGQam-gfs3q7dJhGY_PZv5A",20,53,37,90,58.89
"Plan B Survivor","s51_wZXsp04GFsFR0kHqAkmOpFlW75Je0y5CWZEWDiC0Jrk",116,106,74,180,58.89
"no udyr no shyv","mNtPRQ6dK6z6X5Z9DFKWtloSRpMgPiSHm2BLyeLQzrap-NXaTxoJg6-HiA",186,153,107,260,58.85
"Alerilver","YrkYiLRppc5XER1iv5Fsc6Mmlg4Yu-_uEKxOF_dNAHfxX-tebxuDh0GQNA",276,110,77,187,58.82
"He4venCr0ss","Avl8pNXNrTkLz2CAcWy0o2hUgBWS9oj_mZeP1D7wO9guySE",17,130,91,221,58.82
"aHowtoPlayDota2","4Q1Ow3qTeEuDxNSvBMqEAiYklvv1t01KZffJc-m2EG57JDn6UnvbQqUVNg",101,30,21,51,58.82
"Fà Ru Xue","W0a1jWLt7wu5hi9le3RMGRK4QNmR3txmio-gu4RL0gyHJOM",67,80,56,136,58.82
"Tulz1","ROHf3VrE2UPD7JV9k42SVjM4GXOVNiH4zRgVKgcwMjk8K7VRo7oyCHqOnA",355,60,42,102,58.82
"yamthony","lZGSPVIFXkmZQwvqCEg1PtT3Moth_wyP6tOkIZ-wKIs-b0U",191,137,96,233,58.80
"Discission","9FFKuTg-GL6r-Akhb_lLVysvaHxtbqY7g_pTy3mvCCdqI4EaQCQk6SfMPQ",290,177,124,301,58.80
"eLavieta","BprInqZHsoBoaBib6hUcQC9-kQR5b89Ev2sGTTA4FzoyJ-TFDLUGCPxAKg",229,124,87,211,58.77
"Yoneñ","eAMeFtn49ziF9jnUpfseYs41HlxyU2CK2Fu26jrdKNIskLA",144,191,134,325,58.77
"Barboxe","gIyv8RqgKcDPuoNaLjKU40vwOcRUB5Dr2g8ZYt0RmY_BZmHD6kx8dp036g",204,161,113,274,58.76
"Norwegian Shawty","Bgzdtpvev9Q_app88zKeePwenv4hFd3C-2UheyQY1xQWmsuA",108,413,290,703,58.75
"maik","eLzajHa_6ISw9_IDc73m1NyogV645eOu9oogELlGqi1Xj0o",4,54,38,92,58.70
"Lowbob Breeder","4d83WK3hP1ut8RglEYJQOEvFeAIUiwFf7CbWKWq3hwiGkZNVUkqmnmxXXQ",1,152,107,259,58.69
"DengTiânHei","gd32uSpmU2pIuHJ3js_43b2_5oJPdXRNB9sLvwGS0_OPtrQ",173,169,119,288,58.68
"Twitch EdgeOfZed","2t04WozMYw6sykSttu9rLrMsFuNxyfCTZO0oN7i7yS22qRPzjuFa_yHX7w",184,115,81,196,58.67
"Cõke","MIPtaeQdZcEHqmDtdF2Vld5xMnytqdbH9D86W_umcjIsq9c",87,78,55,133,58.65
"Quas2","osxeZtqZxpT5vVBxxJLbUThJ8U1zc24MIoFIvxp4HaunhHo",464,85,60,145,58.62
"Haise 2","zTV4eCZCyDqLX_r2x1yrcI8MURwRjAecKdgcF_fB3ICi1PoH5oYd9Nwkgg",191,102,72,174,58.62
"Genius Susu","UCG-D66mLURCpdROFq2UvId84qjcFGDyptf6X52e3PhLnY0",1,109,77,186,58.60
"yadi7","B7Zrm6ccAYmSxus3Vs5KKDTFvSUMggAa-EyysDmsHLdNDzc",74,109,77,186,58.60
"RingTrue","PdQWvswQbcLlpemFJTxt4hZEuoTUIawj5AY-0k7zotB6YVKK1mKSlpe1kg",1,126,89,215,58.60
"MYP","xAC6U0oXjFT0czVlud8VNpR9rAntO7qMdMJf_nREc3gJLGm2Kad2dxPDPQ",59,99,70,169,58.58
"Derek Shin","OkyddEtu-ZV9nUm0i2dlTXhw90_GH4pQRprKF8nHdjlhUVA",0,147,104,251,58.57
"IvyBaby ","iO7al0xCNpTirH1XuGguNahldoyd11mqZYxGKjNRhsn_C7Y",407,82,58,140,58.57
"Eyla","aoexWdIBZIKjY-sFcCFZXZlvN2o4SMYIC4ZKBCnuCLiyiCL2TVPu5OT_Ww",150,113,80,193,58.55
"PartyShoes","Fn8IQkzVHHRI0ou9iSC7hdtq31LHjwTY_Tb5xFnUv9KlqpMo",14,72,51,123,58.54
"Nejire Hadou","-BDZuIGA4p8YyyB2uD9QBkIt2-3O8qWfORUJFzIrwoK7YGA",126,110,78,188,58.51
"i am noname lol","hzKxFmrrA58kpZgIosKvW1NKJPnIfDz3xofdWv7IVsxLRbZ0LzhvnXuvSA",186,93,66,159,58.49
"BoiImNotOk","VF1JYjEdS2e0QxDGxZE__hrp7eDptlPUqlL0qaR8aXpLoRDMP0_u9WwYxA",54,200,142,342,58.48
"TAKING SOULS","1cMd53keRa8gVn-pBmEHE8MDYIjXlB2sEURFWOsi7Aqq-C-7Cr2IoRnGFQ",151,38,27,65,58.46
"700 am","TuYu0gUMSxUy8Ai5rPjqlj83W56WaVQnr2uiYTYQ5oE-5hmUezK1D_24ZA",223,76,54,130,58.46
"dont expect","c9azLHlvBWS6YtXMRrL7ru5w7LPlnO3a6XofVhK5b4iBjeRYRVHj6e5O_A",165,114,81,195,58.46
"Daimiko","bCYkHi2OYXQCpSCissi2XN6YAj59TVMvNkD1xI6DeBJDVcI",358,76,54,130,58.46
"top cafe","1n_lG99H6nKN2Fqgsh_vWHASuoddd7yyAMqgIKJ6QmWy57c",15,152,108,260,58.46
"JJJJokerrrr","HQc7URwJJhYgWUjzbCW9rnlu-Z23l0VwxodFNL9BpVLE2Qy8",112,204,145,349,58.45
"r ep ort yi","1rWzYBxAwZJVx578mm46e5kpRbn11b_h-UhoZ2zX5vDr5ds_",164,90,64,154,58.44
"MexicanElf314","kDu2KcfMR8ocZA6qkZ7mJUvcNtFzAqEqOt0HUgacpkhyvATM",49,149,106,255,58.43
"ROÍD RAGE","YeKXvvj0KjzFFgRs-tFm6gJyND6v5yHIWXbH3s0DJ9r217d7GnsHZZzPaw",119,156,111,267,58.43
"noskill onlyluck","VVn3jz-vBQPJKVExJv1Fb23RXZi4aJl1ZlaisEmbjAfw214",6,59,42,101,58.42
"Tiansito","r5ImLqxPhUu7nrhI-Hkuj1Pk7IDOWPBSRElaC9jgB4_Hkbq2",206,215,153,368,58.42
"Conscientious JG","7OSicMUJWV2FETA4eU7-RG2Ha4IZ4YTnAdFfCpNX7eGTUUt8idu2eXOGZQ",238,87,62,149,58.39
"Wumbear","7vqH06dMvMaZoRRW8PdusxtkTRx2TlNJTZASugGxy-pw4RM",433,160,114,274,58.39
"Kíng513","Z0Xg7rNNKkiGRdHhPFOlKm-YWFv5-EcB6V0ian0Uk8YfsUmzSwhgff8ihw",52,160,114,274,58.39
"Terence Kim","GwE4NVTQDiUHdCSg9sMKPN2ZpKVihdS8T4VU40FJ40sL7bWWxADBjGzQKQ",134,87,62,149,58.39
"º Ÿû º","z3GqYu99h54DXK--KK84m7dOH-o7dFeRfHrDMPHw4_SzNA3uksIA821tFA",43,122,87,209,58.37
"TOHSAKA R1N","Y7wsBFTWIUUUtZBw9BoZTSmq92o56-TjvNWBHdZ5ykSefIs",1,136,97,233,58.37
"L4rry Fisherman","oik8285zdNXwesxWLyMaSa1o53zdgjx3HPCE913UukC8A8fo",378,91,65,156,58.33
"Cougare1","wYchStRr3HI8fShtbTAy-VD7O1LrnnmeVM2-73r1rSiJ3bQNM5WgoC7HMA",161,49,35,84,58.33
"lazy cs student","kB3zcUXUYBKh35AMQhBehF0enX1o7HrIKxXR7-zdtZjeRC0",34,88,63,151,58.28
"Phewellynn","Ht_lksgtE65flHDZm5Esh1soyMudwuTqKoksZXuAKTRi7D8w9CZQazxKFQ",34,169,121,290,58.28
"sangy","u19d3tSAi9z3gw8Feb3Oe0gfe5lbZTmWpgubEEA9OKK_YUY",150,74,53,127,58.27
"TwTv Thorntrail","oey9uwseJ4SWY7I_RCr7C5MrRji0aPQU32xhZPw4a7rxQLPJNth7FATTvQ",377,236,169,405,58.27
"IIIlIIIlIllllI","OsmDeiXIoLMFuTe0yaOS2ParUuaapHCceuJi4VQUC5NEbTrZ2ZAfF45xdg",364,99,71,170,58.24
"blazing platinum","ROj0v3ryQTPBXNt9SgbN0m6KcWZG0Tn14J4bnrb2aoIfKV9q",1,138,99,237,58.23
"Just Yòu and Mi","fyr_TPzeTk_opN0WZuTeQFO3e6BzGSdo0DZ8HjfhN-MbS88",457,177,127,304,58.22
"Xiao Suan Nai","Ildv1vmo4tvrWLvgWuBLEOqIQQuPwzRAUroChboyup4zCaI",419,78,56,134,58.21
"lpdpzf","ZWv7lptn_OLm1a3JxmODB6job9gT9Q66PRNPeD7SHR_ktPG5Mk7hzqQg_A",1,110,79,189,58.20
"Bototoro","0NZ0SGONVfKLsSRwyQTXbgR3JQ9ADjy6Vi8Fx1aSgXzCBwg",15,181,130,311,58.20
"Ruxfi","k52HEqZhYnhO3FPIqHC04Q2D6r_u17COP2sl4m1gIiF6eFLwZJk5fipRpA",171,181,130,311,58.20
"bioniclebuilder9","v42uXlm7iAUl30zYrGrHQoALX1nZ4FnleZinPxib7218frYJBkPe8E98YQ",70,135,97,232,58.19
"Alonso2","9YKk_ZbKqj_vSKhamSfm7i6QKat_oByXVJXYfKYp8DDtiEKxN6NnEjUnNg",103,82,59,141,58.16
"Mrstart0ver","B-ErZJglNSatA0Y2dOzIMdkfNqp_K2NK1ZzpTYGm4mRtz1d5d4naoKoHLg",116,196,141,337,58.16
"anywxys","aQSsu0N4Za9Bd8ZrxdbkTbsDwFPogjymyMukdBSDgd89BCA",0,57,41,98,58.16
"maiº","j8eP3HdV9w3st2CwA5huuQGVfCFC0ZOMvaJrJ0AN9Itw0l3d",1,189,136,325,58.15
"krazy81","NvSIn9ECkhwGZreIVyHmGo0QjBkCWWRMaWK2FSc0vTs52Lo_",139,75,54,129,58.14
"badluck20384","eipfdYBddQDD1TEExP6eLQOpco-iSW6RrUjxI2Zp1bDIViM",0,286,206,492,58.13
"Wishless","WqUlNm7xYaK3CAzakh8Ofa7q6WPorr3Xy1iNYz1lLIfK_ls",258,61,44,105,58.10
"TaMèReDaNsMoNjAc","-5RsJTkz-kCNhnBv4Q4wlfcdkMlPBeAIfc96mbJ72hLzYfE",0,97,70,167,58.08
"Grandmas goose","tOUBo6brZme5iUIS05SSlR9ctPmMJTF6wPMnlUfIJpuIBpj73nur194Eug",100,133,96,229,58.08
"AdorableDING","TbcV3vO1DtNuxpZ_8P6_22-nsI63ZucIEB8I9_YTJweNGFI",145,212,153,365,58.08
"SSSora","f8cQgo-htggEKN69px5Cnz3F93K2vTsYrxINuqG5W32gn90",1,180,130,310,58.06
"Brillant","eVEPyhyjnN6EQ_E6mVAsMo6LYu-MzXVTnGojj2_LhlTC00Q",36,126,91,217,58.06
"tenticklesˉ","X0vg-MeqWTFuxR9zuhrSHan4rvnyD9gtnMA9Z29YsDksPtg",304,90,65,155,58.06
"modo sério","jT3urrBQgSniYN1mw-cPxijmuJKFlnfQwZhFaCWHQeJLtUIh4VYaS7p-BQ",26,83,60,143,58.04
"KAT4RINA","VhOs0NY_7wbszD6xGMLjpxInUu0b1UKYk6On6ALiOiE-x-hY",54,231,167,398,58.04
"hope u improve","8Dv67SzI5UUVYXVXSGmLaNgdxxYroMPdZgH4TN9oBalm6BQ1",0,123,89,212,58.02
"ezclapz","fuudT2ubr-oPDB4dV1ze7zRBqhzu7BI2lxxIK0ALCq_DUcs",18,141,102,243,58.02
"ASSASSlN","E1cTOQZPlbTQJR9gr7TrAYlJmqwKq7RiMzsAgVMWG0WoL2X7",47,58,42,100,58.00
"Niikaido","_Zb_TNdGsyAPDmGAjEPmYjro1RorVe241iR5ev2fcan99Y8",431,98,71,169,57.99
"KryRa2","V0NAedDdHeKZGdxJcoEr1UyxoIQieaMbjjyw4rUxCcgZ6JwUHa47J_-B2A",27,73,53,126,57.94
"Monory","TfsJMWjhlKmD2kJMhPyzg4pkLBcotjuAbs1IX75wknlbUnoR",1,259,188,447,57.94
"Kimertonadar","ZBVpQW5anAr9Yh0zFip7dNWxnqGboA3H9szp5u8H3ysx1W7oiHHFiRPRww",225,157,114,271,57.93
"Ginger QT uWo","TSQKK77lzaM_XL5Fw23ZZRicy0pMiN8GCTrH8gbFGm3OLiaeToESyrJOtQ",304,274,199,473,57.93
"sad world","03ZbvHRtE0OQAwktwa-Kl9R8WnPm2E3jq9YNxBTck3IP5GAf",181,77,56,133,57.89
"neopets lover","G3xITyJYDywgm3ZkBIuEbZKgwojbsiLpaCcyQq8ziu2pRpA",188,125,91,216,57.87
"desire to win","7wkvuI-3B36POXT_qbcWku2O9KqYsOiL5NqOqpwv_r9eV5g",114,70,51,121,57.85
"XXXHJJ","fXm9Zn0vot_juZGeK7S-VrbHHwgETxQkMA2Hp75PrIZ9GYM",124,59,43,102,57.84
"Sakura 648","XEKhOqeIfiHaGS_EvOgLncPjhIiG6RPZkLgFKbaBoc3Tg9IWyj3dbjxxNA",272,107,78,185,57.84
"4zeer0","liyGc58Y_m8102kXgOHYCaMN91AZAxEAybbbqF5i7upnNr8",335,133,97,230,57.83
"EdmundDDuang","9mHqDrQVwxWhtCnBJ789NyOElURjBvGEZyi5bseg1yswARc",223,230,168,398,57.79
"XayahsMommy","f96YIEUD8-0-0I8zJzqqxW3XaJHKuhE4KfCwAdH2YjTFPc7q",0,234,171,405,57.78
"Coming","alc4tqlk4Ng_ItviozOIMwo2vtNckgZSX_QfcyKVCA77bHA",1,97,71,168,57.74
"holychickencows","j6-hrDcZ6r-2DyBIevdtYt4ujs7HKYsNTkuHRW8CQydX6wk",225,220,161,381,57.74
"Suppincarnate","NfZhQvdlaqPwm16evhPdWeMo6bIILU-RS3W9xvjF1ZNpfkoVdNwDpV5UgA",176,56,41,97,57.73
"Fidd 2","NCkcK1yuouBKSiPzJMRiOkXgovPSQmSg5rMkRD3b4Jc8zQw",140,56,41,97,57.73
"BlackVelvet Rose","zz_nqn5Nv9LvTUsmB1Bkp1GT6pRUDBzz0JmSI7d64mFkKsY",16,71,52,123,57.72
"dds","LkSJ3VDgm_LmbbCJmt5oqIrR8YjmaOWTJkuTah8M1-ETej4",44,157,115,272,57.72
"ShowMaker","IFki69IJiS1QF9akE3kaCWHWg5b0Mh9xPcgC9hS6XVRH9RMm",300,116,85,201,57.71
"KojoNegi","OLPFaPX8AT9YMOJ6O5Vjz1QcsR1S9Zv5pCgzKCulxhSM1g4",179,131,96,227,57.71
"PinkPanther605","ADMulzDhbqGoGENSOO7i06fxqXKy84lxX3gZymJ1sM5rlBc",192,90,66,156,57.69
"oomfs","-ejiZQq9qO3d4YBH4TyXKQtIR6kL8QF0SMZK39ugEy-06WEnAjXcvyrQ_Q",58,60,44,104,57.69
"Druanee","gX5mI7Sf0G2GeG6r1Gqbk6ZthO_9qYrTDcNBMdtxk9EDJ2n78dI7E-5qDA",54,75,55,130,57.69
"V0idWitch ","gUGwYG2rBV64HUKitrS6sgL08mQI4lOabIL5Xa9toUXCbMs",93,120,88,208,57.69
"DragonSlayerGrey","zHy3o3wtpaEZ0T-TII9Z_8i6JicnByh-27_yCSWRvoxj54Ik",432,94,69,163,57.67
"Gezi","8-BKQ2BXdYf1teS3-8KvHsC0zqE5WxG1VFpVqmQH3aF9PCwx",1,143,105,248,57.66
"Mootah v2","Y6Bal8cLLwv-r1GPGzQVH4UZ-pezswOtccMCWwxUlqtlUXM",86,79,58,137,57.66
"Papa Chanman","Fa9Ct5hTrMAMXcVKzeOwYcbDxRbrhCDUx73a3h4Tk7qFuK4",511,192,141,333,57.66
"Saigonesee","DxS-7ve7shEv1plMVbkz-4I02pofnUECaGXJNb2BrHEEH1k",68,64,47,111,57.66
"Bandito Pandito","CexS4ny1udMew4cjAngMCJcv5U-vuLSSM7yqWxEGkBz-IxA",93,83,61,144,57.64
"Routine","SD0d06ioVPeBYSCSd4en-cC8l4U5P-DqNTzMAYF6-u-Isipdv3PtO664EQ",419,238,175,413,57.63
"Hide the Boba","O8SeE-Yt-F_yUnbsPSn3HvBjWXdPpgpiEqb5alo36w-bl8o",279,272,200,472,57.63
"solidarité","5ybtaK6wCaxU10A1FZwrzbCdXMf9EUs-hMjdeuAOGUdVXOM",1,102,75,177,57.63
"no yourself","DUzVDs0zJ676SnW1N6SKkR-ZBoVKk1p4DGgF7lgE-2yQFnf0",211,155,114,269,57.62
"Best Fiora NA77","yMmdKRy6-i1jW40e6DDFkUSR3J0m-FMp2e7zaDmI6RMEgVnf",59,212,156,368,57.61
"Aditya VasuDevan","9YPM-ru81CluDaie4KypAuIm7yNVbar2rBEfPWO-qcGPZJ8",43,178,131,309,57.61
"Vínyqq","cyp1KEfTDcqzkuamARDN-mB3XYC_hn_mnT9B_l39bjDxMoDo",226,57,42,99,57.58
"Saozhu","txwldsPyvSVJudE97nhPquF2j1EX15uR3EzIOEi117fvfD8",457,205,151,356,57.58
"bu yao fan wo","UTBZjdJBniI3Pkjm5IQuE1n5rUsp5r4NniXPJZuY1X_-429P",220,38,28,66,57.58
"ptangy","I2452k3ZQ34IX2oXTYqLQYXkjN7rLptBB-jbs_K7YlEYBKjhJDiQ9BaFMA",297,141,104,245,57.55
"xGuntae","J6huLqQy0wDfQnnw4jfSBxB5w35VGmXWmRV3cuA_LP76JsM",266,145,107,252,57.54
"graggy patty","DCiYry83cDGHrTZ-oYh74d_YUjlRgt98UHX1bj_e8U37s7G7",456,84,62,146,57.53
"crustylime","lIdQT-Li-t1UEY8Mr9-qYXc1jfBHqH6cDxzbnCnEXnRe_v7uTbw7NFgy-Q",1,111,82,193,57.51
"fatherfatdogcat","CXkCNPWi-a0t8PgB4yqAMUCCA08TnIlaOqvf-j1HKqEEtm4K",353,222,164,386,57.51
"Gg Boiz ","ElsjOe4w5Ul47C7Tt4yPkPwnF3rYHDZLWhVHjG2Hk-lg_m5G",1,69,51,120,57.50
"SharkToDaNado","g2Wb0NuQFwacMWKl5JoVUA4vZ-QkbGGef-y1hvE491TCJ7k",349,138,102,240,57.50
"Fan Kat","3FtuMuxeoyZxujSPH6mJy0_KJCQidYY_tqE0sCiqUkEA-pg",72,69,51,120,57.50
"Duo with ur Girl","aV92Q1L6nd4eOPRiAoJXStRtMe4uDzRRl5LwAhtkcLB0eyI",57,115,85,200,57.50
"Haroldjaxs130","hIrxcjw-cmD4Avix69nVKjEWPGk_MrA89RIvaSEKJiMzZ43TtXVjzsQTYA",19,161,119,280,57.50
"xMei","tqWXwB8ycnR7e1W3_e0bVoMH5Um_3LaDFECM5sD75RnCLug",117,123,91,214,57.48
"GIG ShinyRuo","khZIu8nokZcfo8fskXHMUE7RB7q9CBFbIYrrxVHOBWMH4-k",1,181,134,315,57.46
"Timur Turkmani","SHiiPTiUPX3AMfrn4qAMEoqRKpZM3Mqpf9hxfB3BfAle_2RN",169,81,60,141,57.45
"Woody Fruitloops","29faRSFaOSmtTE_LYAC4R2HDXXNUjRQ6mnI1moLY7n1N6s9s",295,135,100,235,57.45
"FeedaBoi","F2jwY8hvekaZN_CeVGCPGJwhnsiGlnRJblWRj2E4mwPvkvM",318,108,80,188,57.45
"TwTv Kowaiiicat","7Zs4rK8HYoXpSmDtJHBzq-BBwZdQqN_hmp-9eAMR9DXfMynb6wSpQvWlyQ",67,139,103,242,57.44
"Costco Sample","lEuj3Rs_BnxFAoTDfRK9rHP7TScpXcuoMVizoSfOVaAb0tV0czcsQr31QA",13,116,86,202,57.43
"Fei é Pu Huo","iZXvY1U-bdKjOfuipWJe1MFG14lKTEjdbpeW5ZMZYuBLI-E",1,151,112,263,57.41
"EnslavedXerath","O9WqYlbPz4lvPCJ1gJnFTMGB3eugGBIG2JK07PK4qlEtO9w",146,190,141,331,57.40
"RicardoLan","nlnUdNqj70WcBtxEx0vg9Mn2bHm4iX6DbjV-oQbOcCXPSuREgTbNlvQV5Q",300,237,176,413,57.38
"DMXX","hX7r6H-fHnd3qh8dBcrP4EHr6naqqrO0WLS25LHaFuENb7k",0,35,26,61,57.38
"sporo","2gY2NvN9BkIDb2vHipOOW4wM5gAaxwIqkcz99tD6sLypz74",79,179,133,312,57.37
"Seƒ","SHeoOc9BrYnISGCRUD31LzZ7dvACm7A9YjFv-klnpq0gzkI",35,144,107,251,57.37
"WX Nernerkat","IiBmYUkLUGh5uGdPnl8i_pgS8I8jrbs5_aGJ2DkO-jbPEJ_dgOZzQDHe6g",92,148,110,258,57.36
"walmart fakêr","SpOy38zhSdmLvl2aR2hfZ_A_hS0Iqr0q8lVudrimF5wutLQ",74,78,58,136,57.35
"spine09","LHh7ZPaxTXdyxL1j86QRCKzHZPwIGW16S_FoHm7VCUTHK0g",348,168,125,293,57.34
"MieMie DOG","N-dq_GVQKlSzQvqGvjefQb6E4cCHq04CZM3pXlKAmufIiX0",73,86,64,150,57.33
"TIMËLESS","8uROop85yZvF-LhTLpyduJ2cYjGt2KNqAHm6_1TjfUSHTYU",298,133,99,232,57.33
"asdfhjklahsd","nHWfoXKU5jL34MyBVCSGik2QxEQdz9LmVbPBk3VwZG4nz5RUqVe4P13QJg",209,94,70,164,57.32
"Wândàdàn","KbPBKJvjusM6Ke7NMBR05tbDt9KeHuJmCtZelnc4YmAyCggDRSn-9XVs0Q",235,184,137,321,57.32
"Reading Waves","zcAZF3mHVbLH-jUIs9KvsE8PJYeW4vhflWXfzOrsv4zv7dEludZYBxmkiA",75,149,111,260,57.31
"IIIIlIIllllllII","ieL2WlLpQqN_1EM7JIgYfaGTuDdC9SIOhVD01Hb_cYPg-J0",0,51,38,89,57.30
"NTNA2","x1xz881MhW9Vl5TT4ZzbjkSvhpwzgpizlTvr1UjpmgqIW2kl",140,102,76,178,57.30
"Nezuko Kanao","GTgdI29PUCEX7ZYEEHdJp5otBHH6ru2Uh088LK7lhGBNiiYZEiMoFr9RVg",1,106,79,185,57.30
"roll5","vIaj8SbhS3UcdNJRbV5AgL3v23u1ExCYy81_fktG5JeBrYY",1,55,41,96,57.29
"MyPact","2FN5tb5iEiQU_lwvHPGxcvkT5nUbngP2UlUEqr2iEaIXF-6Fh9hHD0dycA",190,126,94,220,57.27
"Almond Milk i","SCzTEu_aPmsUG7SAL2tDfoHuPTadGnEUFqd9ey_iPSVP-_Q",112,138,103,241,57.26
"HyyerCosmos","1A2KY3iUAqyzRcVs2ZCI_pCjS6fdQ1AgDZr5H64dQBofkII",155,75,56,131,57.25
"derakos","ap0qHGOLRE22m2exedSw4RCBe9tuY6m24gBCCUcWwU5IPCY",124,83,62,145,57.24
"EPICWINNNQQ","s29NS142445PdpwohqTjot7mIr6j3_IlN6ke8PBClJAsGqo",458,174,130,304,57.24
"dericsion","nksScvLCWKoa98YAjtrTRPvtwxPmWPabPPj6lvgr73z-WhU",124,265,198,463,57.24
"COCONUTSTRAW69","znit1sCk_1MOgzePR8GApOCP0RFqpyjwffP9J1BuzS-jq5YJ",0,170,127,297,57.24
"Phat Alado Bro","lJ8SmjuGuTr3cgW35UUCkfHlom28A2LtS3tMGRSuLIq4CyM",171,91,68,159,57.23
"Believe it Kaisa","mD28yYbg3gzu6rzfdUM_q3rS-vAxwT_Z3or1BoJjffMQitJPvkGl8IVy9g",287,226,169,395,57.22
"frost solo","L335MIJcBr_mrLd1gq98RrEfe0BAgeCZwuHlkL6NmRVsHjC-teTRG6l5zQ",37,131,98,229,57.21
"Momboman177","5gNIp8vgnJAfTPMv3qSc_bkPgllavZdykxHkzmH6ar6nza0",93,250,187,437,57.21
"Negligent v2","kZviZuLqmsknFaU2tPU8s9THnTqt_wKPyEcLvf8EXNWOJ8u_sHykwCNF8A",15,115,86,201,57.21
"Dat Tran","PvgGXl8o92gG1gCdoTVdIaur1AKYsVmFO8QT6pdTQ3Ju7QI",17,100,75,175,57.14
"Dhokla","kRggLRcDParUYQVdnnACtXEfRdScPKlaidLsRTMtJpVwfOY",77,116,87,203,57.14
"find bridge","r6tcBsQdWWV-C6z9qJLkDusk0oEpxTQq0yocH9y9-NatDCo4",0,120,90,210,57.14
"U Of Toronto1","2tYrYdjZgQ_id6szh8X9Kc-P0YliU951HviWbAtmw2rwREAkx-jXFHuS5Q",245,236,177,413,57.14
"bao an","m9ml82adDZdc4j-bBT_aqYZhJPrrLjPB0IPrqZV6gd3TOzDo",262,228,171,399,57.14
"Anh Già Bronze V","UhLfFSVa1nqflUMZhfj1n0j_7iYN8fmSEQ8RxHxWglaxFJk",434,144,108,252,57.14
"TREVOR213","9GQXHWqFfDrNBHOvHf_bxncXHgynIKUbcrM5wBrT2IMpK6M",30,84,63,147,57.14
"no yôu","t-aoYtmW-1ZfCo5tPaUkW5SdmrvxiqpaR5kgJfMOKgDhVqc",1,84,63,147,57.14
"Wroks","NomY72Ac5fB6v7zM3ADVKVCW48qKkXHANM4nyoY10GeOysc",115,36,27,63,57.14
"Venti","0bXJA5EetFHHTdRe84z45HhA2oWPJ2VD_52zevgVLYlVz4c",200,136,102,238,57.14
"Ashosbel","KhC5EkBmehDDV7kEQYu3aM6gih5mWhuMZ6J-9vMVpuqInZr2aIfCyYpD8w",271,80,60,140,57.14
"CKP FIND","v3QSXYNPA83Yycj778_Wq0bjIbQH1YHmeKuUazOggeVWP0c",490,140,105,245,57.14
"Veleno","dKsWqvZ66ZuUjW4gk_iI2zMihvSrjL6BJOfQc4bHXfQelds",82,44,33,77,57.14
"Collin Cloutier","3MMu9N42H1DFVVlC2RkHGrJ--W-ERvwWvkUksWlVYM34LzA",299,209,157,366,57.10
"Mb i guess","dQ2BtHrQJB60wFpapxd6icMpE98Y3lBL-4wgUgvpkfWgDpWBBuR0i5xghw",453,205,154,359,57.10
"OlderThanYourDad","UvA-3eAUTCdOzRLE5AcmMM_kVHbiqSeQj2wcxKAhMUGBs9XWWWFRnUc0gg",236,141,106,247,57.09
"what can be done","KLpftfSfyvhx6NpY5H_q808yQy0PEaz_NbVBQh8S3oMrl9ycFmvIuJuC_Q",16,137,103,240,57.08
"Hannah1","nwvn433SRoIul6SBd1oQkz7q_5RF6HwA9I4v5Fr_GzvPnpjcV-VLShP2HA",298,137,103,240,57.08
"ChesterwMiIxO","ByNwhozeTbq-TJ86EYjjIIH3-373SLkEpmL6c7FcWljkU_Jt",437,117,88,205,57.07
"NateDGAF","k9NbViIFENurVe4T2IFjyu1Y0uHticQOkv4e7smEZFEpNjo",45,222,167,389,57.07
"AFKRenegade","0yZrPyHssGHBLRNtqR2e-7Xt92ygKHnXKOwFiSRpSeKoU4w",83,279,210,489,57.06
"runamegurine","QLZ5rA_JGh7_exUFb1-C56gHdfPjQDg5UTKNY1VkyyZJn1g",48,194,146,340,57.06
"Rito Pls Hire Me","y_uqE23iIS24ksHReVxrUH8wxyRs7DXsviI4eC3CDJ6prAObxcyIQIbY5w",136,158,119,277,57.04
"Schifo","OWw0KsWvWdWRI3dPnhuuQ1UNFypRYx0oQpk8kQi3jWn6ccR7",23,77,58,135,57.04
"Claw","E96IUy_G-JsMqXLBupUvfxRI6JCYklz1jt8S68-5S3_tsO8",157,203,153,356,57.02
"U are vegetable","kMGLI5RB9lconrxbZqqbttq5oP6I9HrZHcWnXG5Vg0bQTWdd",98,276,208,484,57.02
"Hakuho","FF26VfeaG_Bich64fWHUrKDwKpNta-ByV7Q2yMwWtINLlZk",17,61,46,107,57.01
"Pibo9","3g8PQTF63QbMY_oYI8raeaNg5-vXgCKGcBZ-5nCS9bYP1Uzm",349,118,89,207,57.00
"DontWorryImEric","nbHG9NZQQvQxVgukr69IUpdyZuhpc4MRAFNmMh-n6-cOSsk",45,106,80,186,56.99
"Fear of Max","rnsnM9jr2x8YwXK9kDp37WBaigghw2G7ypiEjwz6QTdtUOQ",162,53,40,93,56.99
"ICEDCAPP ABUSER","Qcxb-H5XjIPhM2uB2yNWhQ_vEsLv2f-K0CK7MPyAAQ5XlKLy",179,253,191,444,56.98
"Mute And Prey","CoYXmayB95wU062Y0hYTRXCKHJCcDiUojZMimaMYmem2V-3kCJNbN81O7A",119,241,182,423,56.97
"NotFlash","5Tn2XGh08smkLe4ud16Ioj5lpZjo8rWKErgRomOx1kQ2H1Ym",82,176,133,309,56.96
"I eat your LP","ceATN3eYgVNDcRhOy5JtIdVCjNoWnX8WqfyJel64RQ7cpy8hQc9gG3oZ3g",0,90,68,158,56.96
"TheWolfNdTheLamb","3tN6-Qv-47thGp0gWdEIUkkQz9zeQeAp7WJ2zcAkSL2ue3k",0,131,99,230,56.96
"A bag of XxG","59CTe7ZffcnCTYjYGlyN2bJW6ZK8_abcNLy2xGV-aR718oo",141,135,102,237,56.96
"la Tigre","ZzHsiqntjzj3Eko_Lsgl1CJkH4mRrvowLE7piTerqIMF81M",24,37,28,65,56.92
"Made in Ch1na","uGXaq1kMuXs31FGI2qx3kN3sGmHyeZgz-OqSYp4M-zNOyoc",50,107,81,188,56.91
"Twitch Plays","hEiPb5HGZi-LwqOl2QhuDEqcXU4Hcsk3mtvEVfAwS0xZWOw",325,95,72,167,56.89
"Poppys Hammer","PZEQIgVrw31RJs80yTMWXgdIwW-B5Ty1OzQelZB4WeYduMc",443,124,94,218,56.88
"wusiyuan","Kkaf58rQvKwxO05ogjV6Rw0Mv1yGoio9eL2DBZf5NDDq0KOi",0,451,342,793,56.87
"PutinSupporter1","brmkxtGgEKOM_TFcJdQ0s5Kdr16QRSUVNdfbfQzLakWyeSBPlK67UCq13g",382,170,129,299,56.86
"Commandress","63H8oFgoxqTfjxSBIo4M0-23MkTWlgzLwi7z2oDcw_Dmq8c",88,87,66,153,56.86
"Kevin Aug","0Nzb1CwSF76dFM_NtqQ_SYLZt77WJ6NvJgODBn8URgt_b9c",447,83,63,146,56.85
"MontyBug77","aV_yE-VmdUDxsd6pdFNzxPh8LCe1iy2OjOKEeMnGx5ut6-E",398,141,107,248,56.85
"dogsit top2","qhJUFjypfsAXyuqkxN0nKKw0QDk_WrhzUbBfyggPWWgsqW4",1,133,101,234,56.84
"404CatNotFound","XuYWWCpNiesF2FVxU_06nA8sG2CYoiHv5_8kMVdcZpZDeGU",41,125,95,220,56.82
"Akira Hou","zk_1Wa1u9qBHQ-p2PF5UTIqeI3vg_LHGsNHVKyMDCWjl6t4",4,71,54,125,56.80
"DuDuº","XPzPxs8kOapctJ1UipejT67D2ubwqBUfJsSJXtC1DM1MOC4",213,138,105,243,56.79
"Raisrosam","ekd4kiji5qZt1gXIcq6ulfs0aSN9Tqaw6JJ5aIP2FSCMjWRG",69,92,70,162,56.79
"W E F Q R E Q","HwfPlCNlcPJKWDL_H6v1WnNuatnj6tqgiCYUm78inb4El5k",91,134,102,236,56.78
"Amod","d3Fsal6E-rHr_5uu2H81w-zBY6KQrBXlRmp5AMP0QvgXHkc",51,88,67,155,56.77
"Yassuo C","b77J5mQstMoOUwiBDAX9XD9T-iV3YDpjaWvKK48eSzq406c",286,84,64,148,56.76
"Latina QT UwO","01N4tWXbmO4Zxsr4WViJGv8h4Hdd33sLMaCezn3aLuVdyP0IpObHVqNQ_A",276,210,160,370,56.76
"Hueb","ZtJdeppRhmgSh9q9shzZDtihkK2rCUXHiQfhdH8t1tGg5js",16,147,112,259,56.76
"llllIIIllllIIIIl","cE6pvcGgsCS65mSSkexsfNGCxi3xGLUXEZMZ6x5fY3rCTCjS",103,63,48,111,56.76
"Bio Teacher","ZHqZ9axdj0gS7bCsxI3EtOKzi7Cx4zFzsCEP5_gsu-eLxD9v",478,101,77,178,56.74
"INeedANames","iF7GEtxge_LJUv-jIzrUufEO3cU-7UDN26NxZ6r24R45L2R3x2PXrHe5ew",1,223,170,393,56.74
"AppIeJacksCereal","JzzvIfWlBthchNNYmq_ZVYhcwx0rVDJKODLq-j6aJac0sNU",16,101,77,178,56.74
"Monchie","vescqldlloV2Xcww8Uu59BtMqPivV3PDjEMLqpbvyflNS1nWJHtMWdlCFQ",83,80,61,141,56.74
"Yuμmi","zRxoqnTx5CiGnfGAWQOfLZzYNGSEBwH9mdKUZ39TLX-oMUin",1,118,90,208,56.73
"Lu1","orFyAUz5QnEC1kUFqgEEBZmtyBbCOp81_N5jyGXfP9qpmHY",94,156,119,275,56.73
"TEAM BABY","Z7QMP9TS7dt0OCglpZTXQockjmBFJKyLKuaChpcHTIiXu7NU",0,236,180,416,56.73
"Raymondqiqi60","O-f-vA86psziV4LWK8IYWduMIjPU7mMRYafz9_TwGdqvV2Bbu4cJ9-dpSw",1,156,119,275,56.73
"Chi Fàn Fàn","uvOQsSr_9gWu33Tbk4vbp354KsVsQaYtRplvypLSg17fCZ8",41,156,119,275,56.73
"Luo Ri Yu Hui","x-E0fPIibXTaTjMCeDGedOlih3L0GIGGzxANCemdIbM184JqJbuaJ-en0w",39,76,58,134,56.72
"EG miya","kyl7LdF2gdeiJ6wey87cEkIlAwm8OJP5CDPhDSCxhDWGmvg",169,76,58,134,56.72
"sjhand12","rjyjvk1K85sUjuzlJgX3Qt4JqIm1Wf08lmmgxGSsqbbPG7JAHnBAkemJ-w",30,148,113,261,56.70
"winter","4QVxrXr35GDux-7xxnjOtIA1GdvDlwXvUzRy3hYvQJuo_bg",340,203,155,358,56.70
"Winter Woo","wSnRRZEQEdgEfvPxvqfAbv4dxhapx1nnYcXQokm0tfhSbJY",94,199,152,351,56.70
"Takinà Inoue","yCLK5ichhG1jbOdti9IXHvhAsKMDVKtdGlt66lmPUcJjBAM",203,204,156,360,56.67
"One By One","XCX_AHj85W_z2kcTVGOwayZqBGIeD1CWSMhQdRdqbVWLljI",138,68,52,120,56.67
"Song Wài Mai","uU854z_oZhVWF7vKMNaynPhvoBVJDgpXZStd9YXYwDtXP7Q",130,136,104,240,56.67
"MickzK","wMd0Rpsw7wIPFFvphw-PN0yCKQmbEEY99rIZHv7dKZZ-ZGH9",256,81,62,143,56.64
"Bwing","0AZBji0brWQBDl8t9rt7LsTUVHfKLwhuwoQiTA3W1zAkNM8",130,111,85,196,56.63
"Kenzo Tenma XD","8GzMYRaaRtU8M4QiGkXHREt690JXHH5OO_PVk0heYyzNsw0gOKtELisdfA",239,218,167,385,56.62
"Lil fizzy","4wC4K81rOzLFUKXx8XUeQzNkcB4Z0Xp3fbJvg3023AwDRzd-",75,107,82,189,56.61
"mmmn","IVJpxA6eyYOkVy3hJ1ICScVru9cVt1MJl-MEa7dXV7TZPF7V",201,90,69,159,56.60
"Tyler1 big fan","S_5NFm0AyjieE22k22MEEzYTwjlXlVfP0SZyQ8mmVe1N4w-OR5U_ZVJyJg",460,90,69,159,56.60
"Nexis","5LWF9A0InhfbzXVStV7vke3f1dkDcGfRTYzqyCVRofPhArA",2,43,33,76,56.58
"Eternal Euthymia","OJnS6D8ApbpJ_BU2wni1EVViNRSRYTSQmSVIowxJKugUX8Q",101,159,122,281,56.58
"DEATH RESONANCE","k7a5OmxFZaQaSD8W-PLogyFT5kUJC2EMbU-LAvAaMTPAtvY",80,288,221,509,56.58
"Lilpistol","hhxhx2Zd5hNpGLg9YNABRu27smgs_kK0ZP-2s25H6U67UN4",18,125,96,221,56.56
"BEef TaTaKi 2","baw_oX_zIhAW2bng93wvVUj3mt-Iim16vuEoGASKHQKLKz5Xr757FG9iQQ",6,194,149,343,56.56
"Noise","TAXmtiqx53A0N1LKzoBTLmpBTmZye7K4Djf-H6zsNqp7A0Y",147,190,146,336,56.55
"hua kai fu gui","wlN_eSuAaZgpXNd46IlRdLVQyNgSER6oesZgko20bk8PO55q4JveJeMm6g",122,151,116,267,56.55
"Grifuworld","NXg0v-SJHSQdwSmamfZmzhGr2lJB_MQpcqwvPva0C2s1zQ8",34,108,83,191,56.54
"sadge boy","lCi9RS7jE086d_DT2o5wFSmHfPvfFH4NufcZYX7lSuynUQW1",71,199,153,352,56.53
"LamiaLoveless","0r6-LoO0kjMbHdiHyVWuAz-0RK6S-iBzOJpF9PgUoSutunU",98,212,163,375,56.53
"WKDraw","qyW4IYeGMobOhdr-4LI3GsGcquSDlMInvh6cK84wdimU_nA",161,156,120,276,56.52
"6 S","q9vUMMshYoi91ZIWrKMMHAys4FJ0D-pgg5n3hj0U7k4VaFc",243,143,110,253,56.52
"patrickStewartt","VTFr1KhLNK5vfbsAthgWP73Avnck1XieNUK3dHEJKZ-P_XtSAkRNzROP7g",284,117,90,207,56.52
"prucax","xMcFrRPGzY1FtzOk2-iDLqA_5a6vULSUtEJAGQ6cfKAK2vudRZU-AjNRUA",77,148,114,262,56.49
"TheRuan","JeL-W6vek_xX3-LAQ5FX50oWixablYH7wO-VdeaM9jhMuVg",272,209,161,370,56.49
"rwqaa","EY5aB3q-vL78OEsnu0ZlvwokuM5s2N9mu-c_BGW7H8ZXnjM",1,122,94,216,56.48
"Artemira","Mj-bMl5JFM-8t74FTw9ea4Lv6p-mOn9JVWwMq0qKk2P1nhk",9,244,188,432,56.48
"DWG Donutmaker","4zkw92kFvdMLmu3aZIXQt5-PYN9ZM3q_EYFucy9kqyvKfTRG",370,131,101,232,56.47
"LOLPRODIGY12","Gx219vujArEcvms1IaE8hSvdG2EuZsFRu-Z8-tfNMze7vUY",18,166,128,294,56.46
"maybe ghost","VUvzTc6Guf3yePj-LFMJ6YlUhj9MNbt11jdrxV2WkB5dw_U",284,83,64,147,56.46
"Hanteabl","bcOKsCSwE4vdzNMUDwhTserDZfCW-cq9fNEVdnbjJibU8tVnkXfoqf7SXg",277,140,108,248,56.45
"zoteroj","l0VQxK3ASnyG8uM2_0nCcLwwM20l2zjZUNgLlijoQxQozJE",383,105,81,186,56.45
"BIatant","j64XlG8ULFvvhXnv0cWWieUsdbL0owBAGeACEi2D2qlZ2xQ",158,101,78,179,56.42
"Duke of Zoom","nhIq5VGkdFrWU-QjwN6B2A065gdD2AHNXY3HvruXnBPj4at4",10,189,146,335,56.42
"maes kitten","9nCCCoBirBGTjKVGGoGiN471an0G98uT9t-v9ff333NTNyfscrPh6hFomA",56,189,146,335,56.42
"VX Code0103","eix79nCBexKTx9gRpMJlUf4EC4r8c75hBSaQ0Jnti8W5o5fbmH8KcH4ReA",1,44,34,78,56.41
"kennyHYPERBRUH","cy4Mmb7dd_SH8lrgS5Ej1XeQ-dOukfI1wGEGfW8XpHeV7KE",20,119,92,211,56.40
"Vexxed04","zozLSN2j2IsuCrqXPQ6nTcwoH4b34VVGiNsiqP9z3NFtYgU",64,172,133,305,56.39
"Reddokuin","Io5sYZF8iVohYeOID-8AlbGsOANF4oz-oY901HMdp1bteRo",24,84,65,149,56.38
"Best TuTu NA","u72hYQQFt0LTQpAIuUDuJ8vSIIgyInGL-c1pKytjJna2Myk",1,53,41,94,56.38
"erii waifu","blTbV5u1Ig03ZcxQYEMHbHfuFfN5Q51JhEp-fR_bcNUS4T8",48,120,93,213,56.34
"Plusss12","KnLBwjUa_eH4iDlgFq96JbqGWf7uQMkEWvmmp8n1ehAQZleBX44oR2k6DA",442,191,148,339,56.34
"VictorDinger","kkCsIx8ccHYodJMO1jk0xhz5bG0jefAJfUPkPxKYFXNNX9LU8wn_8JXqbA",44,138,107,245,56.33
"Siziƒ","fQAulqsm0PbYr95xnTKjAYjw-4s2SlON30VXaMJrRg2Fq5VHqewWPnBWrg",137,98,76,174,56.32
"draterrr","NS2dpgtnurE-lQTxcCMtfPOpb5GkQ36dFl7RNjWSkP2pAow",1,264,205,469,56.29
"school phobia","RwX28lLnyYnZztsFLEOg0pwMRcRy0SVYU1ULTwvIKnQjvcC7YXhEQ7r37A",351,197,153,350,56.29
"Jungler Kami","n2ICT70zkkAtlZY28Xw46wKPt6SmMs1nqazt4ns-fWOGslnrCq-ZG8iJjQ",20,121,94,215,56.28
"12 more hours","nvO1sXOz-8_wSyixxEGj_7Lei8UfTV2o3Ah-xV0SMplhT_w",432,175,136,311,56.27
"GameIsTRASH LOL","PqLWtQu-VIwGYr0iF_CTfwdrJHnUkaCd84ZL7XN6cCp52fU",95,135,105,240,56.25
"AllMightyShui","ezmpw0HZ-ixj1SurQsxYgq93dP5T3slYcb6QJEGDG5hysJDu",136,243,189,432,56.25
"bakanari","_vkiIV1UgUKxc7xB9p04wTK7LTIvpdSFeSUULpacHH3o50B-QXJPot4wow",106,117,91,208,56.25
"xur nurt","QfasVFv8_-8Te9-HxmBFtGN6jhAiU30vNQcFGxt38P-MrO3-",211,54,42,96,56.25
"Gua Gua OwO","C17diLgWw3gDh18ic1ZVc6VEfSRBDkoMYyzUakvTpS-4yfMMxqlh-S_A4w",59,45,35,80,56.25
"GÓÓGLÉ","LIpeXWNd-azSWH7EslPEBx8Kz5ObEKm_KbCEltGRaD8cpS0",343,239,186,425,56.24
"AíDsauce","2You7zInoaFTXFUVnPcsbfkzPP8InhealMVYem2uluieyDU",106,293,228,521,56.24
"HiHelloSupLUL","zZhyViUsgwN4P8V2HGpNH-JCz6oo5vjGZX0ySLKqMPNpBLvIPPFI3LEU6w",372,221,172,393,56.23
"Donbrevilz","fWdpo9hVUOTL8GVlwQXLeJExwWLAU4IEmkWi6cp1c7tw0V8seK2_YH9lug",410,158,123,281,56.23
"ChampagnePunjabi","u1BRl_JUUYprV9bOVlOp1ynwu2Q-RKpvO_sfZMAp_GXaS5E_IIN86fhKFQ",471,176,137,313,56.23
"Indulgee","TLAmcUumVVsPU-h5InO0qaB_Kx0aLaNZv9QMM1TQYtYg1ms",201,122,95,217,56.22
"Dragowski II","ZgKRGbh0GAMVEsYgr2S1RwALA1lgWCYmdpPtWMO26NU2ubEWFrL7oSU6mw",24,122,95,217,56.22
"asedl","smXgQ3oj3Xum_tbNVGN0g6TK_WWAwJTpQ135P_ZiG5mJyhii",117,172,134,306,56.21
"PureSalt","lfIrG3fQiW6ms5HPMvRhbc7jRMA4lvloYPDF5uoxNU2dMMg",193,249,194,443,56.21
"Pretty Lightskin","yKl3G--tFFW56ErRAByngN9Gj1-_PkUB0bqJWn6Wz92vtuq_v2oSF3h-lQ",364,127,99,226,56.19
"Worst Teemo NA","3HfXUjNorM7iw7uvjA4cU2Q7tDdhzY7OL2YMDTn97780rD4",127,118,92,210,56.19
"Reforge99","3k-bEkTNIVQsIs3F3WleELMQfkDR42jsBASlqCPnooSdhu3KDmCO0FYZiQ",492,191,149,340,56.18
"Blondie QT OwO","DqSyy-6OROIZdbkwVJ4ONPv9yiQzgC2qjd-kP2dDfYLHVpoEA5HkwGt7yA",140,246,192,438,56.16
"L1NG","XPONE0hGKWFjFa4feWL7z0PNoJDF399pFO9Os0ZwUcx1GWY",215,73,57,130,56.15
"Zutter","eIbb0hmFAd0qyBPJgwHKBME2gBZr_CDCuIIXVyrbxFYnVHo",198,146,114,260,56.15
"Taz L2P","C1JrLPjx_R6onnYtTtH_4FuhLKXtGgxPetdHqjFM7X7ovC4",0,178,139,317,56.15
"Noyes","50rQ0n-pknnPCFX_ua2B7Kz1IrV9SXGHNSkiLx75nVPXinI",317,128,100,228,56.14
"Cooolddd","zcb2ZAgwnMeRTNqFQpFg5PNxMBHw5R4Kjo-s5uWtY7f0gig2",136,265,207,472,56.14
"Shapeshift","Vb0kQ4nEYOEY1Tq847fHEgT0dBOAEQFuK7q1ZR6x_yKX6yo",241,96,75,171,56.14
"Kýlan V2","GuJ0uTlNQYzgic4ZZUbVmXZZa9kk0_KEcUoDXbk4ma8XRhhBAmKH6iGDGQ",46,87,68,155,56.13
"Xiao Tai Mei","OSByXbK7zGDO1tL-TvYQz33L24XFq37l6ankfMSPLy1fhPU",0,119,93,212,56.13
"RengarMane11","FigobEQlnIAQN-ByC0wkEQZhytj0JCLTjoiucM1JZQXSSVM",236,302,236,538,56.13
"No Focus","_yOoI3uyzYbreK2VMlQZE_dCCU5ld6MWxe0jWAzZYDutpBQ",231,174,136,310,56.13
"Sopachi","T-KN_bYiwNNKprXWblcFqxPIsbK36SRrGgEe-03_iJyDSfs",285,78,61,139,56.12
"PYRAMIDPOWER","-27Zl2aBoNdUDqT2YXd2mbXnOS7s5hQ05YK8_geCytR5AGn1",83,101,79,180,56.11
"Sir Rouge","7PtXCd5czRjMtt8MxEpcdVFMrqBEIjHOOx4FJPjqkR5HEzI",199,152,119,271,56.09
"KN Tony","SxMU5-TIg5AgCqMHfwht5agGulWXL8tY07_n9KI341z3zr4",90,106,83,189,56.08
"Solarbacca","L-jyyqCbMKcAot5WkdMNAFUINpZxVwcVAhvuX_QTgWYgDTM",316,212,166,378,56.08
"CAT CRIME","92dleOulIppxa65tyd9aUyx9EEgPVtLwoMycSJCH7iIN",259,97,76,173,56.07
"Be A xiaoTianshI","tz7YCm2TEaSjLxQXaBG_Sd2WjqGpI4Xv0z2baMz8ImqZTEE",127,74,58,132,56.06
"May I Play Yuumi","fAhiWkVBhTqc_amMguxLVb5rl-cUYYsfnLSB1VnzzvHC76IJ",286,74,58,132,56.06
"Slainy","u3rJoETRSpNWp6r2PNUlJN6lwaMHW9emZRNvJFqdMsNhRac",283,111,87,198,56.06
"Dinner","J69UH0GDlj-YOssk0rXUFrShEH3DwRhjx7MaaBnYeiKCpls",300,125,98,223,56.05
"Better Call Sett","0OmDpsH2wH19dz38hJIrRcba-QCODu2Q7OXR6zsAk7aAn1TtNEGZkqI_zw",235,223,175,398,56.03
"Cedgag231","pLszdoJrveRxFlDhTEEWz-4oqy6C26vb1X4beEk8ffjzCq0",65,237,186,423,56.03
"Silver Paper","Y2_jjjIGoG4DkpUFdDgzTvUbZMCPfj-HdMY9L9tMfU18xOQ",255,79,62,141,56.03
"Dusk and Sunset","eOq1WKgB0lEa2ROxB4ZSeGSs75KksQYL7Ln8Oz4LQbXAkbw",103,79,62,141,56.03
"Tak1na Inoue","uIwqcsfg8T-kuR6zfOr1HYPMtgxxhPh7k6CObAJrQ5CCRRA",146,242,190,432,56.02
"Jasmine Blossom","B6AMP3Rxlw6fpx0O5ATT681_3bAnk85OtAJHW8FeN5_GF0A",157,70,55,125,56.00
"Lance Jarvstrong","Ju61TzMKu4qpihxNLXnuqYfzAM9uuplhKYTDP-xKeriA",1,28,22,50,56.00
"LL TRIGGER","hNuEg23fWMeHe0gnYfwg72GSAjbTckauUiRN-FJG3JnE3v4",479,350,275,625,56.00
"Icaranaeb","TdfEAa41sR_EWrGRoB9eYRApswUOzDk3T-tqYdOWIjuxIsnyBLbynSzK3Q",50,243,191,434,55.99
"minds alike","uynha4TXCpGq_Tug9bUnDTNu0vqUYJk3namf-ygnVrCQmvdIkLhJPghlDw",143,103,81,184,55.98
"Arcane ßlade","KrI1k1_rOFdgeMez2sbONqLS0Is9Klwykk-kogps0bHlnUqz",313,300,236,536,55.97
"Sheeni","A2zQX9cuaE-Zi3FrKKGTEbeHvoKqI2yCo1XrUWUMgvQQuoc",55,89,70,159,55.97
"Windperson","fYECv22VI2OqxIwyzA_qqmnP3MXS4iP0gleSKdhwgcMF0FQ",276,75,59,134,55.97
"Im Fern","1_DA-95qFB7DeZW7j8Z4Djj9vx0xB6PiofDjhF_8jfpMQgw",1,61,48,109,55.96
"Kouleuvre","J4t9KJhkG1q-0wImjM71rIykJ5uzJQSMXPJV47FtfSzpSiY",249,310,244,554,55.96
"jonhdo99","Tc97XJujzZPhCJE7JPlOVwt5u98NAz6iiJV1emwrVI-nH14",317,155,122,277,55.96
"soraka hypnotics","Pq9seaZNN8tqMt9D4yBn3pKFhCMi006EDCTnON4hccMnlpI",262,249,196,445,55.96
"FosterCity","sqZW57UO_J53n_b9pPhU1VhkMfrQlvUQgVHA1ccKGPnFC5M",35,94,74,168,55.95
"WookAtMe So Cute","f15OZB9OHzr14_xYgt0GqDRultaEV4tJPFfeBCM4G-uKdChc2CHSvPJyCA",128,113,89,202,55.94
"ChrixD","5hEAOdYjgMW-OayTP16jHfgTtldB1Ym8lSBWtlg4eMtk3Yw",79,146,115,261,55.94
"XinLoLRawr","q-NpXY0OJa9KVLmbM9mV3mlmj9UvcQfjLfwSeZ1Zir63lVI",125,132,104,236,55.93
"BooomYerDead","xXb8b0q6Yc3FClcGtwkUv3zCMkd8QM_GPfCyQa1ye_dlFMo",16,118,93,211,55.92
"Darn","2_8YJqJIJlisSM6I7yaWJo6M1doAaZKf5yU1F1xsvIxOZ9o",61,189,149,338,55.92
"r1m","I8N6zBgEckgxoyGDs28Dr1aji7Oe779yuQkQLJq8p0FcPc8",133,293,231,524,55.92
"pumpkinpieftw","OdOqtYEmkpSdTUU3U0OEXsQ7tFUvi21p7DMp563Hd5Ozqbk",276,85,67,152,55.92
"Keren","ZSP5xgwihvA_D6IFXBxDlH-L9BEaViAXUB6BdKoLL2UKVzI",61,227,179,406,55.91
"ASH444","tNv9TuynKax0DLCqzQ5U3lCKfhhDssz8yNmENQUDviyCDI2hYctQCW28oQ",50,104,82,186,55.91
"Pawnies","Eh3N1-FFSlAjWahXbBgZVyCCqQ_FAbF9QQ68i6ph8hEiMQg",55,218,172,390,55.90
"Weakest Top ","ElLu5vvdk--gyKGBu2aQRWgSkV8HnpxjionZLDBFudfXWgw",61,218,172,390,55.90
"Sasuro","aM7DIqVARINTcxj8V1d6UNrbRw_myhs1F6jsXlvE0Kda9Xs",351,294,232,526,55.89
"Excalibur","KhfCh8oBsDWuTtd1LyDrZ0wsqJ0XMO4j4CIx9uvc7JJqjd81HQOGl2ASHg",308,133,105,238,55.88
"1v1 Obs","pQMjw9dK3em-k0uBvAmtZpx3z8ueedtH6j2rTbLy7kW6ShhP4V7nUVwJ6A",110,76,60,136,55.88
"Erisnadar","KsXa_AtLmixgPT5Czw6tL99H9R5QQiu6-mNOAphe4S_00aw",0,295,233,528,55.87
"atkins2","4cXP5FbNRX7mIavXjihdpzuWs1yvnJeMjbnyiu-9tzzaBWw",354,81,64,145,55.86
"AnimationCancel9","0Vn4P6CT202uCBMCmhkHp8gKrZFOG8qtLktEXoOc4sXMX85nLBIPlSm50Q",0,234,185,419,55.85
"Zeneryth","37PnYRcpy5R86XSgeEn1s1Um0Dvi51ko0bdqk4j_ohrnra0",321,91,72,163,55.83
"Yxzuki","7RC5LEZpSQ32SmmxDwxzjBF_1PCUxGUDMT2ahYe8djdafkO-fpGFoEgRVw",451,139,110,249,55.82
"Junnypoo","M9ypnhpRGk6ESDlWRvJnOSOw9YDcyYTH_ArdBwNUAcisZP4",163,72,57,129,55.81
"Tddy","iNK0WuYUyPP2Ifccw385AthBImb3-sdGhRbneZgPOrteezI",113,101,80,181,55.80
"Aaaaaari","A4SAsy53vQCub4XJ09bljQlwfWEoOWJk-xnerCW4vJF3-1M",394,236,187,423,55.79
"LolliGoesPop","iQ1YZaTk7pZh9hrUuuxHFOCghxmVPfKFyh2daML5gLW8In8",1,53,42,95,55.79
"TEAMLUKEE","D461I98u7TXPlH6mmdMjCw_ncMlQifG4AMwsP6KhpUd9QSI",336,164,130,294,55.78
"Meaddyana","WhTPAhrxDE0J_0yFmyDCEiBPifZToRhXeXJEXSYIctdRar1tkgc40zoCgw",10,82,65,147,55.78
"BladeFlow","4SKyok9mgGQdGAGwaobjj8t6oc9jmF-1zwz1KA49J41X9SQ",129,290,230,520,55.77
"kaliFortune","562-hNxO_DoFyrI53wtKHHnuD2JZx6sJGuP9wnR2k-qY3fnv",447,150,119,269,55.76
"jioji","I1MCPs7nHpumSqpNgSdglmqguT0L0q7fj2yjJf82DFFdblub",84,150,119,269,55.76
"S8 CNMLGB","H431jcbgwXH_cePdKFIRGyPZATXBAp0AiqmBWk9BtFbIRdk",99,155,123,278,55.76
"NA Knightzzz","IDr4O98fCrWrwSrGvs_ukp0IfcUYAKu9c7QvZEfxWzLtN8Cq",87,155,123,278,55.76
"cookiepop","YTYZTlmmH40HlIr3-tOB7-Tg6hE68WemkSxkCyOpaCZlFVo",264,97,77,174,55.75
"Akali Gasai","Lpn5As4P0g_z6QnuENnbdAj16DmWgJMjFMl_l0xlmdy6OuIFeHU-R91JrQ",279,126,100,226,55.75
"IIIllIlIIlllIllI","IzUl3B6wJFBoceISTXa0INdyLqSlN1D2VESEVb9_FfMrz6YN",67,68,54,122,55.74
"SilverChase","wo4JjXfEpNI1RIHmdsKu961MZBJLnIy0kcjq9G9KmFceBQU",140,301,239,540,55.74
"toghhuge","8L7wpZyXPXxwX04ynxov5xWJ6YnwSmZOkv4aYrVXDTzzpeI",31,136,108,244,55.74
"Momge","Ztztf2o14jG68-Dr_-RnJVVtiASfhLXyqoEQFr4id9NpGGKTruIJluwFDA",17,136,108,244,55.74
"twtv YunahTV","dC2JP7jDOjGEA8GgmPS5I8dG5yJ6iRJ-f3KMqstqhbCpEDTF5YDQqY9NwA",209,199,158,357,55.74
"CampTopYouNoob","u3Zz3RiHFx__UK4lMCsEdE1yj6iIBWRkbu6-o_rb04Vr3To",286,88,70,158,55.70
"Ayrianis","O5dT0UXvsqK611cVO5hYTiRzy8kHNYWhB5gDjD6j3XDqGuT_",1,127,101,228,55.70
"Enrique2pe","wpJSGcHIN3QEt8FublNek6ZoOb_dwbpTrd3mmVlJUFScntI",145,44,35,79,55.70
"natsirt","taolKy74C4MFWvuW06QUxudCV2JX8kYNf_QDKe19GhfVQKY",1,186,148,334,55.69
"Dugong","M6WVpK-v08i8-rGiqlkivYpq4QC5kmpd0PQ74bLfyy1vi6c",305,186,148,334,55.69
"Namssy","hnOMEm1I8m3HRc2bZzNM_4kp0nDAu8nzE0PDB-5sgd-T1zY",51,147,117,264,55.68
"Gööd Night ","Qt9iawbJgQcphQf1Hyn2dg7ortwu9kN8kd3lYo1OcnuQ7cY",314,103,82,185,55.68
"SaucedandCrossed","4oEpkEnun7OMQBKIdWd0KF2nCH0ubCfaZs1ZfWKPZQvsc-5ikqnjJxgWsg",319,113,90,203,55.67
"J Ni Tai Mei","5JvMmqY0u9bqDT8clVhrdfHWAlC1jGLqpNcleTw6C4UfNiI",85,113,90,203,55.67
"Kophi","Or0GYb6Qr2u4ULjAbb8gn0QErw-wypZh308kYBZZFBR87bM",127,59,47,106,55.66
"gg23333","fOujuXokSYUwFwXkZwFgzZtJQ56IhosfKrA5bVFNU6c35dM",31,305,243,548,55.66
"ComeMid","WVqshlz2JquqKtk8aSVtPZU_lvFPCo_Tupvz3tFSEsiCSlg",276,207,165,372,55.65
"Dyna5ty","mzk64UtBmRbSazU4To8xXKMWetyIJijAI-EDFpi46fr36fL4",1,148,118,266,55.64
"Rucaetizhe","_fhUbt5_OnB4dXyqBYVcqlZyzHBRzarGjFjpsy9FI_9AEyDW",62,158,126,284,55.63
"Comme des Hommes","jprjY5aGUVue9SAeJt9m0vVKIN8ejIhe411RROFm-FQFe1Y_cvGKu4r8qQ",269,84,67,151,55.63
"Euphon","Wzof2aCpLtmzYu94RHhLyg28tZF7i1KB3dmUWXos2OKnbX_wfkD5z-71Yg",200,104,83,187,55.61
"Jarikay","O1KNQjQXo6Ag3qaeTLIevRlrl2T3LjiTAOdCxr8zBeqowMI",9,134,107,241,55.60
"Vin Blanc","weUxIxqALQXrpkGs-UI4cyIl8NxBZyScFp_rPx245yKZsIk",443,398,318,716,55.59
"ItIsIndeedYaBoy","Dt2MoF-0dhTkoiuHIMKfK-Qfram2A-RTwy5J9Zjmxi_t-5Y",123,174,139,313,55.59
"CodyWasTiny","pJRClRBT5Pm1c0wS0NaHgAJ2PRMvvKt5_DVyr497UOQMLcQK",220,209,167,376,55.59
"my dogs alt","ht1iznNtRdNDNKMkL88vFRWu0_NvcNFGQ1FFnWIm9i2lJ4Hu",163,219,175,394,55.58
"AM0NGUS GUY","mRXnc1zbgLDEdo07iZB0IoTdzv4pcrsTTDqq7413RrSoCV8y",47,284,227,511,55.58
"Elementzzzz","WUSX1VnRjmhmtnZxsn0fLiJYbqpg0oF3qFzuUUomnn2lKrU",1,95,76,171,55.56
"wobamr","uWNsNQIpuElyAT2kHfQVTLdq16oE2CI9jw7_02GGSei6XRHjlOdfEeZ5EQ",35,155,124,279,55.56
"dotorimuk","jlliwu9LcQe2fBCJ3nHilH36dUQrT4fDvpop7mKefhRg3sx4",30,325,260,585,55.56
"aninjaponyx","3iHbzIUYCls0dBaUYkC6_8ph3-LQAvEqnpLT7AtBnWoCQYk",195,290,232,522,55.56
"Solarcellz","d4c2CSRzWjlT8xl9Laf9auQN615zwFAvJ6HbQ1IyP6wDzyE",472,100,80,180,55.56
"Dieinsunrise","O5MXuIoDkINhCB4aUYuDu_nwLbCJY0mMHFaeSEBVbnKYY7y0",8,160,128,288,55.56
"jamaican banana","rNBXBPJnjoh40ykzLMgsTDALzKpdvLAAMLtv5eeKvEIS-wSA6q4IMCI1yA",366,115,92,207,55.56
"wmvvmwsrv","s-qT0RXc9AOyILl6dKlw8p_RK8lg9OnDUrXg6Nj7JSFD8H2lEZ8D7nechg",128,165,132,297,55.56
"dont play ezreal","iihje5KiG9lOZh4EC4zz6pDhamInLr-k0Jluj-zkk0E8eHE",1,90,72,162,55.56
"Rukø","9lS4muSE0y__Q2JIsst0i8d_QOYL6D3Fooo-fPy1W4ozKIg",286,206,165,371,55.53
"Ømusubi","1yhqXjHM4bwngzx1zBjdRXx6hYKS4i08bZ8pHzLFh4dSVnI",265,176,141,317,55.52
"positive mental","mRwGK9juVasok2N7g64WYvdtLNopRlAUvqfWRfo18NtPG_A",288,161,129,290,55.52
"Extan","F6qcv57Z3Rrb2o2febVGUiByz0ZkFAmO8zdPZUGLjH-mrDE",333,156,125,281,55.52
"Twitch BTangLoL","dFtqHebViEhdte4pDP2VUVmMMMTdDAy6DV411cOjzUnuPh4",434,131,105,236,55.51
"UnreaI","i9AI_D-KOh624YwhxgtNvZ9fVmYSGaI8xQAM8v8eAyVqk5ieKoVugpswQQ",91,252,202,454,55.51
"Bestworrier7","zPxp4zyGWVeRcrZhsPUgFKg_47QEoLoeUnxNn1xulBiIHSVj7GqOoE2FYw",98,121,97,218,55.50
"Useful Kindred","3HqbFhk5x2rpEHrO9wLK_SUOsUKIGAQdIOuyRCQivUyhgnTL",67,106,85,191,55.50
"Dinna","RVmKiINbTwQVRjhImxyL5A3RlXBEFdGhHHbcSRV4VRzX2yI",374,116,93,209,55.50
"Dinosaurus","mkTr0qP_z-itL40QD1jfH-eg0Q1YwfZ9pN3ZooOrsAUM5ug",221,101,81,182,55.49
"Pålette","C_jjP246kZvnps68qOaByuHM1qefh5w83hb72hRCPIWEuio",34,187,150,337,55.49
"EDG ClearIove 12","z5CJeezEBHZ3uboHrmqLLwr0Rte3440crjMhd-7ywF0Uab8",160,157,126,283,55.48
"rumomon","gDrIZUhfX95ct9wsIjLdKI6BVsEzLunEv9VUDc0Ex8B1FcSkI_rCs34bIw",293,86,69,155,55.48
"SUPERSTAR1","cNlkqI8BMgrjlVc_UNqLZM-vSP0iRWJq3rCUl7Zjh1-wUK4NtMbhIH1T5w",142,147,118,265,55.47
"Noctuss12","9s9Zn0xeIZHER5krVNoBZOR-fZMhQEcH42cpcf8hwK3B5T7_",332,228,183,411,55.47
"Riot isthatthem","34MJTFXYCg16YlCsMUF1-QmgqezqBhXPIaboswFqe3V8YCE",363,142,114,256,55.47
"lllllIIIIIIllll","Lj5VyKHa2o0OZJqKfwVgQFiX_xhF5-ebnMGJzWJK_L1nprJc",68,147,118,265,55.47
"O81","IKiKv1fXuwhO4lzSG635R58eea0GxIFSaGPwfgs1cfYDo2_J",440,132,106,238,55.46
"dlwlghks","OexL6262GTvZjYcSpTQbmkXLxSbDsRgjvVTI7J-uMq51mc0",108,132,106,238,55.46
"CastleSmasher","qopScrJQ9mmG-I8RJTjc3HAR5IVT-jg_2mnGKMhKpJ6IrdY",372,132,106,238,55.46
"hvedbnpqs","1i0CPYhrehJHmB0mpUiE-zIX_yl96_RSmYEiijapuQwCb85mFdjB2aHuFg",18,320,257,577,55.46
"TBones","sjFqCkCEmDHhYYeWuxPuvIPGu-ZkEYFQ37YOGLbt2h7D8h4",390,158,127,285,55.44
"sonvu","sxG7xR939RwOz1Na5S0k6rDYEX69ws_cLcWViH4d-huJ4vc",28,51,41,92,55.43
"Xepherin","VkRYQx--CXwOehfbm3LAkDyxlQjH6xb62CHZrCw6AlKk37c",45,148,119,267,55.43
"Li NaiNai  Sorry","ipdtR0djDirccChi5DTclbN4q8KjaAtpqZegJQlkS0XJ4Lg",308,51,41,92,55.43
"AłlPro","sJeR2ONh8bOKcNi14FaEk0k6sYJDSk0G8KRg3c9yKe_ojRx2c--b9qCynA",105,133,107,240,55.42
"Grundle God","pPmGjNy-0iFREPo_RM1eHXQSL3UtoTY1tZdwdYezwNfuiWg",140,210,169,379,55.41
"Cardiac Arrest","qOU9mNvyfnsk-1-ylMeXomz5tzvRlvUoUKsJB0vAajKeL4w",94,77,62,139,55.40
"Tyrannus","w1hzO4dLGkt5oevPGdLx4QzPa-TTgJ48csK6jKvUqTkPzI64",156,241,194,435,55.40
"BlueHells","HaAzy_H0Y6VV5C38Wo9kaN_z_Yx1cQNSKkgOgYNCtMQNa4rfxDtvykW5KQ",259,154,124,278,55.40
"Lux","hLX8rpSvpTcaD1XDRe0DH2aLlV3kXzJ9OFK_haJhtSiv9pE",258,72,58,130,55.38
"auburn flowers","cgwI5bX5K-zkFqQc3Ro7UGW6_KnoSf8NRbmxmWMY2QFwOW7n",0,72,58,130,55.38
"TwTvItsBoyWonder","sdcIxSlRBsknk-6vIsq8hqohr8X1cLgd_K5nbFZuwjTzeH0",0,139,112,251,55.38
"Top wo Nerae","D2vOXnZC1bDRkOeK9w3rooKv8aoBscYtQzHLEakmPPVM7DQ",113,72,58,130,55.38
"M9 Eathern","_imWxN15z8TABMNHbp0_5ytOzRpsfSgpsC6_xOMwNIzwaoIM",311,170,137,307,55.37
"Fairly","Y307FCDjyAPnakAo7cgQZARwDX_Qe0PZqB7HcJPbExA7JEg",160,134,108,242,55.37
"Holyfk","OpU_KhDq8BjpW_jTAvNhQF1TuszAuRHhHfAYAYnxFeTh8Vg",359,165,133,298,55.37
"DankDankDankYes","vtrScJsQ2t_bD5GgF9qDNsSnvMnIp6ZzsdMDuBIvFTfu7WzPic6M51vxFQ",184,155,125,280,55.36
"Xicovon","ggYbXotn6bxG2NHby_bmdxjOtFbM-1_rnJBuMmIhheZ9Qr0",51,186,150,336,55.36
"CE Akita","KBXtA1QEZmYnRiODzoz17HgaZa1fXpBoukiCMlNFm3_FGA8",70,62,50,112,55.36
"Tombliboo Eêe","p7EhzwU_B3JHcPiADf9qJ6GD-CHihRLe8GtsplFPB7eVBwA",14,93,75,168,55.36
"DeKuadro","i8RI_R4XugiGgdcMSRAMQVI8BQIMcV2w4gmHhbejY21I2ik",347,228,184,412,55.34
"Gray Paper","eNmj2646KqwEqWAyUVKFIy3cYwN81amfzaWNgJa5KpwfObo",135,140,113,253,55.34
"Ho1Pot1","H4kyRxoleJDzuOXpWJR2Apqoft0ZnQQrKIFpUTC0ZiJFgugK",1,374,302,676,55.33
"My dear Zero","itAG0lhE-r1MZHmVGXbem9PVcWfyPlP_4ZyMGsHmPjbv147e",81,83,67,150,55.33
"theclutchfactor1","7LjyBQanVkt-DvdkIyivJd-Q00_Kpvp5wwdRQ3ThnoPzg_BY4ctMNWyc0g",158,52,42,94,55.32
"pucci goat","MPu-dPfHtIFFCqA9dw81IiZFfg3lxIlaowO8e13jlaSnNdx3Tz2gUdaLEw",426,213,172,385,55.32
"Piemaster","jHpcwBMKhBu88aypT353HWlZmPfPMv7G_VpAqX_84i38b7E",60,78,63,141,55.32
"XXHEROXZXX","FUrjM2TdJ0CgMnQeAVqe1AI3cextXpDRI2Kyfh-mAjPF7wo",163,255,206,461,55.31
"Lêaf","S_nyr1kUVFbL3jpWOy5W2Pf1g9He6Fir6DuOIAaKY3F-8-D0",259,99,80,179,55.31
"Sveronaingab","bb3qnKnnKpah4C4xlFPMR5kB2eVO_1QfwUz8TUrowESbjX2UBbblT1dv5Q",117,99,80,179,55.31
"devalRDH","jZb-uqGCJC2NhGcz4_bvblj686xMgW3GBtrYpgkWA-sPyzk",179,281,227,508,55.31
"kRYST4I","Lt1HdwRczfkR2RA_mrsXrmE-2h4WTNXL3aQr6qfBjm2TxC4",234,73,59,132,55.30
"swagkiller23","9UTMKwBrFJyKSt8A2qHlRwUsLGydSvFFOr-aEdtIrZmiE3w",266,141,114,255,55.29
"Fokko the Furry","QHVR19PauLsu9x8ViReUurMVf6jyFPuLIVP_nmgI3a7rLs4",117,183,148,331,55.29
"TLHonda Gankkk","kGeaoma8MQfxf_k2NgK2q4XL4ktMDY36sKVhjFlWsG1mq7m0iPFPVJd8uw",220,94,76,170,55.29
"FAAAAAAAAAAAAAIL","hUzsX2tDLPI16wI3M7le6VHrnB8JuJ_oybHLDWWgIVfqEhd6ZWTySUDG2A",1,136,110,246,55.28
"Adouphoof","wVsnQmIpd4__oN1-qvVvhlMbTRi5wCUfleuiqLB-8YukWbM",140,204,165,369,55.28
"HĄ1","EvM2xkBcgDEomttaaahyNBw_6HkQIupLAKxhOUCybIKHlvI",36,89,72,161,55.28
"Mungar","QpLD76UIfrl6H4aHEZ9I4DzHPWdMuvebPSZXyo6qWBGH1qzjcp6d60C0vg",78,283,229,512,55.27
"GIG Blank","arSKHb-XX8yv5IzMP3jVfibxtQoYgdNlwB9j0ufoAN9_CNE",1,215,174,389,55.27
"KnightRoundTable","Ai1EZbLJqkINkVJTgk0xK5M-1ZJN56XgqBFniiVZHPDSMxE",443,131,106,237,55.27
"Berei288","ILwlHqirIb7QfQzDzTgYwTttijRG8dPANSC7JXvhlxNGGtw09siBkLyiwQ",1,194,157,351,55.27
"ioplkmjugwacv","VQsh20vJBx_wYP50C7x-Yk-FRP7o3Gb_oZaqdjWbW3-6USy8Rjv0nrH5MQ",445,294,238,532,55.26
"Xayahnara","o9lUb6oCERaQfb_aC3KAsgZHH2UdMM-ekoYN6a6fgqME8SI",439,205,166,371,55.26
"arcatesythe","KWB9pGxwADkJAsCBeE_1Fc1TzjdQQcllQhXVbq6SXqMer6M",0,168,136,304,55.26
"Tøkyo","NKepL76SF4VcUfQEetkT4yO5uSvc1V1pi2jjJiAU5cui6yPq",87,100,81,181,55.25
"Vñeráld ","9miFtZA5fdy6-PR4sGAN9oox796ZyvzZ6r0zNvzyARItqD4",0,163,132,295,55.25
"175","3Rj0EO5orHZpg_xVvgUzuotiCjjG53dIUVgc2Oo0HNvrUXI",284,258,209,467,55.25
"Reiiterpallasch","0jd-mJQV9uFtpmR55per-mBxqdjRln3r0QOrFy6YLkTvY2cc",177,174,141,315,55.24
"Shed12","QieKqMBpuuMJbxdR03dg-vTs62_XrsVytBItbuoHurGLX9c",0,174,141,315,55.24
"TempName222","g8XzbmgeIgsNJOy626_Hqszjc_oKaASB5Xc-2pUSeWEuQaD9GOrM9FqZuA",218,253,205,458,55.24
"kanini","84Mvk1RRbCf-jRFAQQgJqOdGoxHIWDMlb5mhK7Y2y1aad0Y",225,116,94,210,55.24
"Refulgence","U-d30eh1WDkMJA30l7gHxp3ZpRITj8i603qV4r3s8V4fBSg",443,290,235,525,55.24
"hun zi fu zhu","yZSL706sgwrk9hlvo8f5OO4mdZR13BeGgJFx1ICw-4yCbCtC",20,132,107,239,55.23
"egghueddfgjksgaj","NQieEC52j4Z0ByW_-5H7zpU3iCbx1dMny3mTBpGv_H5FEyv4",346,222,180,402,55.22
"Chords","Y4CWRphLWNFks9WXVC_HvjWWCfdh6y44EDy6phsPnUf1gdw",1,127,103,230,55.22
"Wohx","MD3pUCIw9glF3WySCgyLBqHQLz5PyzWGTj8aYcr7jwbBnHQ",127,291,236,527,55.22
"Såmira","_641f0xP2U1xljSuzzBgffuTnfVw2MeF8h2k6KJYay4404ke",143,127,103,230,55.22
"ThanatostheGuard","Tq9Sl55oyyOlQJUJ6XJzvMpY9ZEa0jggRWjnbNPUHU6owRs",61,90,73,163,55.21
"DieUnderMyAxe","kF9ZHYB4ugaBWBVcAAT2ypj_vXB-N8VTWdzk1ES-9yIwEDY",57,318,258,576,55.21
"Jenny Mud Five","hY8Yz0f3EthiX8ckciM9bzA9clk2rhjFg-PHhbRuEwfZhtolfTtnVpk1aA",212,53,43,96,55.21
"Pusheens","9vB-UUlKQV0bOsRYPNcSXFdEt9vambntH7MxRJIh4boGc9k",165,159,129,288,55.21
"ohg","FNqLrH8eFBy3PKMi2kCg0SV89pWPXMH9Iex_NXW7V7-2B5im",464,233,189,422,55.21
"hiaa","scMAEYTuoxqSCfHexMdJYMlOMvyUBcllNwQDSsC8UpquWB1h",122,69,56,125,55.20
"MrNoodleHead","4FMeD68CcIVI2-soie8OBUn6cJru8SITk6iByAizslMDsW4",211,85,69,154,55.19
"ExuberantRhino","MOx7-ale-K3iisL9lynpsloIXPFT9apWHXbItXETd4U5zKD2ZAoFli1AEg",27,288,234,522,55.17
"Akuvis","ngnv3NGQpRA1wbS-KalKJ57__OLPtn9RfdoEQnU5maW4tRjC-XYV4oXVjg",400,332,270,602,55.15
"stinJu","2FsawoJBjeTUrc3CzsKRckax0D7jK_GQe3vYQLFrC355WCg",0,225,183,408,55.15
"SupaAtNA","DOaNM9PppgPT3IrLmVGnPbWgY_lvPUuFiNtn1B5KFHtSkVE",302,91,74,165,55.15
"emiyaa","wOzbo9i9l2xEtw7IaKTbJbnut9LaFLEcyXRsME6b65N-OlM",430,161,131,292,55.14
"IVAAAN","JT1Up7atFQhUEUyqQSyKDxWsX-C-RNcrbhW4S2tn4kCyeGOwc5_xiCG1Jg",246,204,166,370,55.14
"Swords","7P0xwVcLPhyG0ovM4e3UaxUKKLw1D6C8od3ofGjqamxkDDs",288,102,83,185,55.14
"L i ã r","q5bz7qI1bsde-rvTbHuzJQ2tzQdPOs0WQnhACyjKXY0Wsiux",122,145,118,263,55.13
"lf Juliet","glB8TftPVAW809-WPDLRjdlZ77kfSIaTUbQeA4rtYBxeBtU",22,43,35,78,55.13
"BUFF TF PLS","esGtJD0l7bfM8W1peiHiPcHGdS9Ad3USDpnFE-KsP3NwjW9N",341,226,184,410,55.12
"Big","3Qnpzk_1mM8dWbdMN_j5r902aTRs7XjRg5p-stTM0wRaDkQ",114,350,285,635,55.12
"live Iove tickle","YcoJaCePCbr-V2YS_I6O5RvZvREh1Fnt0uJx4wDYQJs78rg",415,259,211,470,55.11
"Muo","BFGuEibX1wX54G6nFcf7csaUMQcH4bUlXY-PXeuxpSPgOO8",160,178,145,323,55.11
"kid intellect","H4EPg-8L84Rv0_QdckwEr7X4TYj1VhyO_xPu9nH6GImKGyA",394,249,203,452,55.09
"u get no hoes","qfVHwb1AxALAO2pO2t1wZ5fzuDpAa7BKoIdm40nQqpHv_2ENLrAlee_jQA",149,211,172,383,55.09
"steeli","8SKtyJWmiPBwN6_2Kthk2_SD9XIgQ5z2PQObS3gzx3Sp",417,103,84,187,55.08
"Workin On Dying","JfRK_w0rwDcVKRt1Uscl67d4oA2SaR3axsinw81Bm32p8nhb",278,168,137,305,55.08
"TwTv EdgeOfZed","XASuCJgQw7qaJ0ct9XahB2Ql5N6x-3jL-cybDn8QJ6j_f-M",125,130,106,236,55.08
"Kowo","YmzP1zbicA_mVWZ4kEnyAZV6zylAmj2MFiClOYV4gzOUcnd3",79,114,93,207,55.07
"8052017","krl4MNrhjdd6HBCPpl3UIpIu3avDtIs-YqKbA7oAUgPFK3c",1,38,31,69,55.07
"Gilo Lord","7ZU35JrhX7E3XYUzkLnuCLrSfupZ68HG2zYGNOBDgBmTnHc",144,239,195,434,55.07
"foreveralynne","PQ8aSaoh4rOO1sB4b4n592Lsa3mKVODABuT1ZLAIUyafmePcbN0yd_u8Gg",397,76,62,138,55.07
"Paku v2","tOhKiNdvqGhg0ffb_cz2GGplLDQhQ-VqwGPHyPjPDpVcIGA",53,125,102,227,55.07
"DarKCoS","f1C7ebta4znyeFowqtfaqI2SD2ZSBs_uTxfEpgt6ZC9-PXc",320,196,160,356,55.06
"DogsInSpace","gvYrUIzbDdvldRl_AbMFAciiZqKvAdVzzXSQJgZCVoHsDRc",128,180,147,327,55.05
"FeelsVlàdMan","0XodqPgP9iu8giMnsWf78Vv-6MmB2GVMj6P3sCUpc2r6E6U",427,207,169,376,55.05
"ThanhOSan","yPCtpA75TbyzBAo3yOgIJ1QCzwnenBzph4qIPRzYzZ3EVd0",177,158,129,287,55.05
"no mistake allow","lUhvY7286beImhmVcq8Ut0dVzlqTRdzyW-QIuWwmDOdpP0U",316,207,169,376,55.05
"CE JT","zQMwhE2mIH-KDvLe9p0-zxSrlpZhCdbew92vEF_5nBZNSFcITrLGBA6juA",174,131,107,238,55.04
"mid ruin","o9IoV3BSck138cJabj1mEuEWHN0JIuaCUvbLmi_BA16j4Kab",253,71,58,129,55.04
"Toxic Gerbil","KzxojYEXgbo4DGEOiDR8NBspmmLe_csUqvjw-KQi1as3xLw",10,175,143,318,55.03
"cashierprison","MsMxvalg9kQqtVSeg8Lv9qAMHxo8kMpxodeM5wi7C6NJV2dOC09QkzlVzw",238,312,255,567,55.03
"Virsep7","b779SWk7uCNtMZsJUa0MbaZOuQ1Dh5gB98y75mTj2SDRhB-b4MZlGmI28g",48,115,94,209,55.02
"Good Sir","AhOaCmvBgejZuCrVEv0fMQKw0UFXq_rIbha1G1Rl_nxfP6w",190,115,94,209,55.02
"BØDY","ASrPO_ZRTmH5w57EPj2GvwGDCJDi8sr2ZQWKcLmsc4F8_b4",369,137,112,249,55.02
"Chenault","y2LWDO1BAJyU4WZow0pajmU2FR8PzmQYHLuba_zEx6lKJIU",163,225,184,409,55.01
"wqwq","pNOKuQ6ZhmvdkGgt2My6XMO1UsXFCI9KdVC9f9nubBSeQtPw",1,192,157,349,55.01
"Abzorb","vQXSu9THpYp0Wg28tte6f-ktGxfqLkkNmHDNEciGcA3Z47I",111,203,166,369,55.01
"Ajiro Sh1npei","xIxH63ljre2tE2iNshDSrVOYUt1bIh_XoyA0e1LFnioCj9I",372,418,342,760,55.00
"aphromoo","TWeiIPPbdiHbsSdhH9ncGnJX8CzwQEWFuwbKCverURnD",50,66,54,120,55.00
"Buriburi Zaemon","_iHlQpdrX-1mba7WkDsHK0lT0_T3m7RkZIsx0FwaCMkfaPk",214,209,171,380,55.00
"GúYu","Xi2I6ttH8e11b0jOp8yJsCI1FrbRR9uh_H-rzL9YDtJMj-4",0,88,72,160,55.00
"Julien","TrC15OiXWaPyj-U0kZlr1tpWopC4WNQkwsd3PHqq5_MtDn0",225,55,45,100,55.00
"ponkins","kCZXSQZ_nIhmMWrNOeU1TtmcIq4sl7N6WopjvNWvUTEtvrA",1,171,140,311,54.98
"SecondAirbane","xFD6mDpFz-kZWWyuuvkxlIjyD0ftT1zttTlnrkcynYfBd2k",93,116,95,211,54.98
"Claire Pommet","x26kLiYAItD57rkBo5elMsz79Fw4LIgjuLey4PpwcXUv_sc",50,182,149,331,54.98
"Thunder Brother","gXEQz634AbFw_H-lZPmhQsBkeQoGeorIenvcgwYvNI8PnVI",16,105,86,191,54.97
"Cincinnati","2W99zChvD68QHWrF52IPnHzuo884dxUNfwR41qhVuqQPwFg",48,105,86,191,54.97
"insung trash","zXjIaPAEKajw96qDqKBugLk5ic2xTzTkVk-nRK14AmRHRZmBvERsGflonA",49,105,86,191,54.97
"SaskioLoL TWTV","F4X_7gF4xG4vPR0i4zyZCgPlvuk5kedEXtFYa3gUIFWz7Ag",270,166,136,302,54.97
"ÒAÓ","7fCgUki1HrU53ye2qMdsw8ylHgKP5kWDvPN7gRdTiDtX0A3MdB1E3DUWLQ",119,188,154,342,54.97
"Yuzuki Jungle1","p3SnxEdN6eQiNhSamVbZUYaP_waF_0_eQNGk9ALxaNjXwJMXH6YRe_I5kw",109,94,77,171,54.97
"Voxtrik","0VaovhcVXaD93pkGTvBBnPz5ACuH2O8-tOIkV0uB0lKzCwo",175,188,154,342,54.97
"Constantine","Cr1o8d4Q5OvWYKddGqCjpQFzE8YDecLIDvG0VohT0b53DIWV",92,50,41,91,54.95
"Roamabdu","52spZaDFfALHBeBAmHyeXO2IcvcpK7SQcGKVkO6IyFqIctJuL_cixrfLbw",321,222,182,404,54.95
"neinei","6PdrZQGyydG62X8b1XXdogMSKo_IF6lPU60ZGNbeIoGfos4",128,100,82,182,54.95
"MoonLover","XfazNngrP1I7lHwBEURsmUEUK_aC9L_pEQq1C2YwSfOD-Ig",400,178,146,324,54.94
"pet owner","eaAavA1UcFAxZYCqlioJ1xhWXngZ7v85b_ubph1JCbg5GkCb",144,128,105,233,54.94
"Unseen Rengar","GRpVPe783D1GGn8RRe1nsSFvAZDYJx3BQgbtL8qT1KIQo48",32,156,128,284,54.93
"Leguhsee","QS_ZW4zDabTXYugmb1oG3pTg7TiVrmPhMm9QRx0d-3cQiA0",52,179,147,326,54.91
"RemyHadley","k2JjcRNgtUbYU2FLpl9epXjHIe3ziFZP3vVNpnbLEUyJqDs",210,319,262,581,54.91
"thebesttrol","CKqgOI1ABxQCI2lDD0vDH6VMslo0wbM8N4RzR9YdjECDCiE",208,123,101,224,54.91
"DirtyMobs 2","5jEBSlkk5gzkb37vRD_rufHMIsRUgacP4I2IQdFoKv4KBQ4",4,191,157,348,54.89
"Rich Homie Jayms","cJ1nq7WJxRGGgamTCHbmBlaF27LxJZUS92IpfD1EGCiYjPM",225,101,83,184,54.89
"Eternalwinds","_7HNtaALGJdzJbBQtOOfDaLKnN2qVI5uJYSDiSf00nwUbcY",68,174,143,317,54.89
"Extremely Stupid","_SUr0FqMN85AP9CwrUdbuq9MIk7i-_RT1PSyIjvcrHOFK1U",162,129,106,235,54.89
"PINK SNOW","9XAKyPfk-bcmzBRhkhKPZjoE9wtlpWN2XUw6_VrcGeJ9cNM",0,129,106,235,54.89
"Lakshan","YfdnpCyYOiKc1ZV0SviRrCse1Yj6veLdLoJsnm9YMbmDq0w",294,326,268,594,54.88
"MA Normology","EHJHwTNB3moe_apJe8omPnmDE9s29Wxgc8_JbHWqWSqjvsw",1,62,51,113,54.87
"Ipone7","w6lagZzDn190JHdJGR0UzZdkTQk9tSe8oJrFKS5m4WS7u5k",214,254,209,463,54.86
"Logan Richards","NND44NZLHiY3QbX_tqdEAl0px_9Ii8zyavxNIrOHWOWtLq0",121,175,144,319,54.86
"NhanBI","_iOMbEyhl7FCdPFg1kUvy60dexGAQ5BoWtGmEm2zvCNrr5A",1,130,107,237,54.85
"ban malph","z-2RUtta49JVgGcB9wFKWtoecF_VH7ADfIrrGM8mVerz0_0",0,113,93,206,54.85
"Môdern","b9k5eR5KObR05VH7cmgk-ToLEBnpzKTn0j9DUSZqPXDBmWq7FzhEMBleVg",294,243,200,443,54.85
"Rahrunhahn","uw9kbJwwELzfDjbUugTuSCshNAyXEFBcb63EguZYCnYBFOPt",223,266,219,485,54.85
"suckmyrainbow","XLAaVv0mKrL5zPmkgPlFhNV9SxXtjqzJdB6RJ9tVAVyC2S0",74,339,279,618,54.85
"Timeabuserr","jkmFwSe7Mhnwt8HauRV2b-8oxhdKQk1sqBs1ZJ1yG8JD-8s",44,130,107,237,54.85
"Giannio","ihxR-yQuzTkA9_5YBdwFyne2VlW_JWnR_2aU1YpLXh2fJLc",154,221,182,403,54.84
"Chance WRLD","rJvBDjAkbdukJjr5Hcc5FhsKTJ80865I-P0NTBXSLpvYlK6q",261,170,140,310,54.84
"T1 Liquid Simp","nh71kUmhREt-53QfLkGt4RHqrR6AeVJc3rjmdrr6dLzQAyM",22,68,56,124,54.84
"DrìpDrop","T_q6Hm9i8PybdpIxSO9LSO3Meh5RnbMuCppOdxlcSOPyw5Y",182,142,117,259,54.83
"Lord Christo II","w5F4K5zpMauu0oViNXKA6TEcxdlEBh1NGjV4XqrkgcRkaEk",218,278,229,507,54.83
"Sabó","T_L6P0lDY84ytQy1_uTdYNJNVWRkmwg_h0p99xhcS-xYQok",50,91,75,166,54.82
"23072022","UUmdMKk6R_CFZ8FsEyapZqig4uNOqUTlHovHc0uuHfXERMWbVbPPzyCrVQ",459,91,75,166,54.82
"Josedeodo","khjrpHu8xQLkF_uMrGuXmtMfktNRyzQNoQVx8pP91AjY2_Q",333,285,235,520,54.81
"antigeeous","1kdMdaHzx8GyfxaMz5a1QwIW6b0OJ9UlVhVvTiWaA7UtJbzw",38,285,235,520,54.81
"Bouillon","fUKywrlIECGL1CIMW595azaGjHr6ox0wQl1AA0BIOqOoGUzW",0,57,47,104,54.81
"pawpl","TmdOb3-FW0kMryh4JBqc2wsaapOk98POVAniTgP8NkZlKe8",1,370,305,675,54.81
"MidasViva","hjybKtN6tCUT2FCR_l0e86TR1MT75cGGI0GhyLHNi-8pszc",1,325,268,593,54.81
"chunkyfart123","nm2MBB85RCLkJ0lUC4tu159DwyB8opOK-iykm2AGA5Amo1E",16,97,80,177,54.80
"Daeyn","Ra92FTFcfilO3bSMOcz3j7rxLREhBEnqdvNsCDQjs8jXtDA",176,154,127,281,54.80
"Prudent Recluse","T3geLuOj2NcyGTcAGXoWwvVwm2FL05qvl8RaaSlmDLZQx7I",1,137,113,250,54.80
"perfunctory ToT","cmeVcy7OK3SpyQ715r4_ttx_tqJjPnE1yi5ImJrjIX8FZG8",89,40,33,73,54.79
"Venyl","BXVNaLPbMwX-ARGxKwIBABYsAe577pJ01i2fV9wVkDcX0Iw",51,206,170,376,54.79
"Large Crotch Man","WvtHtN8ar9Ky4MLdJoIDns8uWA4sdnQ5yAVU_G_Fq1HlMvo",403,200,165,365,54.79
"LostArkGamer","9T7bGHaKk3ehe4ZQ1qH21jRD7YUjd720o32N6B-EUBqFh3kiiak_DvLXZg",311,183,151,334,54.79
"mairyu","ZZU08WFrthR0k-opPQavNadMqa9Mp8LeFiI_y2ggpfbB4bQ",1,252,208,460,54.78
"Kyleg00d","BbiqtR7kZ2mT7YT3no71hlICPmwTc3yKxTLm4MiD74zrT6c",178,304,251,555,54.77
"Keetchie","xrBhiDyEtSjnq_g0sGJvUZYTnS9PGVinBW4jJlSm8Q0_jwQ",394,161,133,294,54.76
"Gwen Stacy","5DSSQUfL6FjtSK1X28XyEhIqU6p7oQsC9_phcVieoSGknmE",80,213,176,389,54.76
"IPlayYouListen","ZteUyx_8qp1kDFt8Y9Ak7_Q6RfW7an5WoEbKOSgnOjxHzxQ",408,69,57,126,54.76
"Tranquil Blossom","Z4TyzOuW6SyyMfwwQ7GFtWBI0M-cWZM4_RaV57k8ZXrB9e-E60JqalbdYQ",186,161,133,294,54.76
"lankylegs","pKmb4RW1b209Jfm3ktY5T4hL9RR3TmpzOgOu2UB-cJrXHxg",233,161,133,294,54.76
"J0eykarate","u7C6w2_vAPF9G2T7mTjesbNjAYcuRFQMUnyZQ2-liRlCtlxTx47nNxarJQ",38,259,214,473,54.76
"Always Against 9","qtidDJuaqyHIrNjOEncB4LPcuoHF66GXXxP2DZQjbr9n-7vZxD3Y_jEcyA",359,167,138,305,54.75
"NGÀI Cân Tho","fXvCQ2gVmUha210_FGF4ABnjIslXRNZQhQ4uWHfC2c11y8g",183,242,200,442,54.75
"Hariltocb","DZWCu-bM7AMj2qa5D8GhuZAppqMdoORJrqStCgTw-seBGJEiGchCBm4Qrg",271,219,181,400,54.75
"Azul Phoenix","62BkshCfgrMNnoXpGjcsHVsO_e5w3UZUbOpIxHPjKgOCLt_0-RzFxDlWzA",445,357,295,652,54.75
"TTV LimitTester0","Ax2e0u9g8AxT06vp45rxbNbMcAbRMd6Iybqc9UvcVGcxfc8BlWXaIvk12g",256,231,191,422,54.74
"otata4","nanZWzjveCCLK-XtDVKfjRujy7W-ciTMjhBRlGeRngu4_uh5",190,260,215,475,54.74
"richshi","rkiZF_1v7_--UOYRwoY850QwuQ6xf2Ot2RLBglK3Yu9CiIQ",95,81,67,148,54.73
"0u0 0v0 0w0","db8lwwfLY0cHOE2g1S3hIl0YP4batq4mCHg183MmygNlq5A",94,289,239,528,54.73
"FabcakeSwag","zLf0QXM6ZJP7WMGa_SgnHXG1O_PU_m1NAoqfGLY2BNNDh6g",16,185,153,338,54.73
"Prince Pyke","sqo4pxWi42UwXhHVp6fSbvmSYSBmnpxSCZqekdYlUF6L4NtE",72,191,158,349,54.73
"empzj","2K2wMgyRqDBQ0QX9olS5_mk81Ajl8XAvqNMb2I86Ss40-5ongQqy53G14A",18,203,168,371,54.72
"Azed","RRX4IoBFD2Kzes42EZGMS-UjzsInlWUIKWWKxq8HYY1aM84",38,116,96,212,54.72
"Øne Lies","SB1XbyVZbKGA0Qu6gf1G95CTWcBBjNcKRLprt9JD-vGcAMs",1,58,48,106,54.72
"Mong Ji Hyo","XXm3Nlvw3ES2bLB4bm549KO23F2P766EFupXP4UWfu4",441,209,173,382,54.71
"Pukesoda","JO5zbJen0tosQloD4ok1RbVNAJ7ucNV6YpWBGGLHRi3chQo",166,122,101,223,54.71
"Twitch RushFrog","7EavJUKm8mC_0xMgFdGX-Hhh_yjKeJuhFNaTjbN9PjvLuPQ",0,93,77,170,54.71
"sdzmcd","9-trFhgL7qpNBSznJRBiTZ4f9FftpY3GRnbJs2kP94dx-RNy",92,355,294,649,54.70
"Save The Night","VnCK0vcLXzl-HvxblXI1LRH6HmDF1gTqf6LECWIwTFIT5DM",234,227,188,415,54.70
"Legally","B8tzIDoskKSEJwe2CZllpkjWL89HqssIE9Xsol_8nnDlMyE",213,198,164,362,54.70
"too soon","1z_NFsAD1o1cYTjG5vUXUkcXo-Auitvy2IaS5U7T5V-VXh4",432,163,135,298,54.70
"Lillias bush","eBN1R-fW208smn2WdyzlOQeE18apSdJ6YdgS4YU0HG7OJw8",137,105,87,192,54.69
"Kuga Terunori","7ooVdA3v0CoVUE4tX3k8JMQNhj5zzCaWl8Uf1a-ElBqQE1U",135,204,169,373,54.69
"Kenvi69","QgkWMtm3YlddHSdOELa6ti1PBh_Zidivj7UUzmBXXdGgQ5w",246,76,63,139,54.68
"seek kindness","3rk5trq78yHlLXWb6qohmXzDOAHdbVhDo2Si60cOSwHFEnJc9YDEHLd36Q",16,111,92,203,54.68
"NewFruit","UFi80I0yOO3dm3JvuLz-9op3W9N1A_L2Zz7wxMNfigfrjaM",236,76,63,139,54.68
"Ch1oe","BrsUWweHuHXUiKOU_mnCZJYar8d8sXaaihl8ZQ9EMvSKEI4e3Ten1ko8cQ",31,164,136,300,54.67
"TvSting","kK5VEn6QEiWn9O2fxLVcsSBt85DSesN49dRTaRWjeU4b3oE",39,164,136,300,54.67
"PONZ","Avcsr-SjBLV9bOuVMnZkG0wm72nl5WyngptJT2j1n5a8X-U",230,123,102,225,54.67
"Spawn Camping","attT23dkXOvbwig08Fhy2jIq_8yjbSn_fpze2EWzZiUNHGAW",163,88,73,161,54.66
"blueguy256","dS8aRCX8DrtTBMKlENvb4vQJ9Z4GtV2dKa6_FnJZ8mWgKoM",1,129,107,236,54.66
"Eliespy","c2DywBGPirASO-EQodxnK0jzHsDGXEU7-6K7DyzuNBovzDw",31,135,112,247,54.66
"Lyraex","DbN5CjWhRNpZ9v4fLSAlLT-Tgij97byq0wwKRH2-2DM6TNQ",119,270,224,494,54.66
"VIT0R BELFORT","BIxQQQWUX-kuhx-t7bY8m4rmq0uaQ4o7gt8hQMcGyh-IjOeXs7Sy-KmlVA",282,147,122,269,54.65
"Muffined","0iXCXAAlSEwz0DFLwC4wC4Lz-dQsN2YObV50IHfKvNuvUss",1,47,39,86,54.65
"Fòx","UdYi013Ki_sg-c2EWI7VDoFPGyaukLuhsRGuGfrFOHn3efo",70,141,117,258,54.65
"TyIer Blevins","b7BxIg0BuhM9G0uJyOh1yQVE8etMXRq-8-XUl5-MyAKN1YMPvMkVSClE_A",169,271,225,496,54.64
"Reposaito","5NYQhDcgSfXa8oOoOoIWkVseztUmhOJTgaWCkPuv-j5sv-AZupaf6DMX_A",1,106,88,194,54.64
"lil bao sha","1CxmXerNn8kgZH0tsT2VtMKVN6ialp-NxFJmY36wRAjqs97y4hStA2CLOQ",216,218,181,399,54.64
"Xiao Lan","rsWMPalOQKsKYx5QT2F4aCP5SwYjJFo4MqNey_zeZhsZ3iOQ",83,53,44,97,54.64
"Shlide","I4rAJ75VJU0RRbX7ajwbH3MV9YzSCc4fQ-11txS6cMu2Bc0",78,183,152,335,54.63
"FLAGGED 20433909","9mHPcslP9chC_gBgdzd2Lex4idZW1RONIQtZmqU24eFu8A9q",178,118,98,216,54.63
"lucky game1","Vrbtxk7cUBFBzS6AO0vRQutN4ZjKxsAFsTmPhyIEftyorkw",135,112,93,205,54.63
"God Saiyajin","Rub7NMY1TPSsrjpcLVyca5RYYN7PylPl-v-BPfU7-47UOB_Y",122,59,49,108,54.63
"ThadCastIe","AJMMZDlBu9W65cmjb0TqzCh4i0Wvxf2S4QM3_I-JziL-skpH",65,213,177,390,54.62
"NEVER LOVED HIM","bIZE7bNCVvRq1KeRX5KEl52LUfYzZj9JxHIOgh66C5LuFx8t9HdEpJntYw",15,148,123,271,54.61
"Genius Girl Kasa","Rb4dmRM3BrWktyJ-ZTYbKYZDwIBAHCi15lL1zXhYr6zIW-Kc",1,154,128,282,54.61
"Ashwin","6O1DjVy7fPR2QZCqcm6hB9jw8XPzxpUOM3bTRm-Aqc5xnBE",68,154,128,282,54.61
"Kayn Ønly","7knudq8-CBI50H6QiAB8zGe-4PjgpOoqjqgxVKXymKGSxu7b",39,89,74,163,54.60
"WoZhiJieBaiLan","N-L5l-ECSay7BSdyykm8HLaGEglIRnSpMaRD9_IJb2k80fc",232,190,158,348,54.60
"love you","2pRQWeIsp17o9B4DWbkmx_S8KmQ2a0zQpqXrK-yv0PTGh1IfPjRRlU19-w",133,107,89,196,54.59
"AVG LEAN SIPPER","g0uI7XSMeLX1HcQWSSjl-scb-r52xRiwf2-hG9x-4Tn0x-vo",165,369,307,676,54.59
"Iced red tea","FolVkqyk9eJYrHoNgVlHPyJWWPhtyKy-9bLDVqWvam0lMOk",449,101,84,185,54.59
"Sev3rd","9DjxbnPr007_zDcMu6h8rNXjd4igrkIExIYrGzn493et7KA",106,125,104,229,54.59
"Reforge999","B0D1spSkmkp8No1dz2aZcX-iHK2Lh9Lbvtb8EtNL9DAwg6z8JIlzY644TA",390,167,139,306,54.58
"ItMightBeYaBoy","06ZF6zB-ZCvS6CFzbHxYLiSKcBTT7k9FSG5335o_ZKMcQms",76,161,134,295,54.58
"ShootahFanboy","cLIaEderpCJ_CpS1ks788TrhZyzIaYXOYDSkfuDRjdvmmQ_f4V4-aZc_jA",362,328,273,601,54.58
"Lakefront","Q3usJdKwS7ElrW8dH_dcwjyJsGeG3pTw4yIgVxbnp6JZDLY",142,131,109,240,54.58
"ététerijtrudsa","PJe5Nxq619IHPnqF_lU6gcb_4EL4__8-OmTK7LD61qKLydkr_MEW_REC0g",372,251,209,460,54.57
"Horang","rcGB51LWHixzEHLiCAFhhNT8dQk97DDNegUj5OetIocp4vY",17,173,144,317,54.57
"IRS BountyHunter","2AmIl7mxnUHey8Vu6FcEfxNNFpbAjO54mmchdsDo2bpXxTo",345,203,169,372,54.57
"Leave Me Alonê","ov2L4-PoC0nbTn605d4-eUq7OXhyYW0QxMpgvv3FJIDHBfo",1,431,359,790,54.56
"IllIIIIlII","H298iyBrfN43-4zLBlWihgbOWu5XFpa_vrz2nnPz0BODdvgfahmyO9nIWg",23,186,155,341,54.55
"Chat not enabled","Fg1vtQXOIcar4_saVQDsvBiPYEhWBv4nOOhyuherhPEAWFI",20,60,50,110,54.55
"Unity","sRf9eRxnebWuMmOZMOpXNRe10tzWwAFYmUIPE2JBldYJeuQv",476,126,105,231,54.55
"caozhizi","wkJzbQLdZRgVxnbgFhbuJJPVo16vTgGGi-_RR85SmD8tAbez",49,150,125,275,54.55
"peanut19","ljQcm5RlqHEWFQ6Y0GqUGJLLtF6TNZhe6KF8HnCRLYFPW_g",260,186,155,341,54.55
"Qameow","MjaDl81S5sK5gFvQF8t2C2O-EwUt0k9a9fzSQ13VL8Gqm-I",271,108,90,198,54.55
"lil fire cracker","bibY1bdE_795u3J5nQqt7r8cS2C7PaOXkmKpsWD2TmamfAk",255,66,55,121,54.55
"IIlIIlIIlII","gHX0Jvu4eA-AXDOE6plf7_e5y-prtvTzsqTLDXiuGp_11x0",79,162,135,297,54.55
"dragonite smogon","E5-X5eps1UKshZNJ-0iqLXcrM_uuhkEz0uwslpwNqqkGlVM",394,420,350,770,54.55
"icioai","YTt6s7LGcYyf01_1zCGwx5g2JraYwUPKVLGHsNSsj6l8Yzc",39,228,190,418,54.55
"monkeysand","S1sy2Gve-Fi_u4Bv19AYVS94dw_l0ol2t9XT9t7rClOu1VK-",91,391,326,717,54.53
"TheLonelySher","Nx8C-IPDbscQJ7cF0b0JgzBgy4YDQfN5Dt2YHMx4koITmxs",0,199,166,365,54.52
"XxYasuoGod420xX","EaXEehwH1It9EjKuhBxBWy1TSNME4sUUuzVekmaQTy-yWIA",66,181,151,332,54.52
"Pap John","kWH8B3zvEZW8YQcM4k-du7i9NXDSgPcbvOhcxBmibBV0TsA",243,260,217,477,54.51
"Lucky Impling","moWpZQHsbBULU0Vw-t5IzPPkR1ikXzHBTcKm18ZIR9RFeEZitX0KR8yGOw",104,127,106,233,54.51
"EternallyDavid","h4eMT6zwb3n-yMdu31qXDllGy2WNH_qlCPNS4-0AKF3Czsc",284,145,121,266,54.51
"tikimagic","WKL94QNjpTFgEMIhMj4lEquCoh5YDtUQSYOj8p7-HCR0FFg",170,242,202,444,54.50
"1ron Revenant","GII_fJXugMEnnnCHCvytimKoLK1vrl75bGvtHFsTQPxgxJc",459,230,192,422,54.50
"LFT Vertigo","AibVVWCrJRAfyi2bOTvDP-XqKiwv_ZmtAToWyU0lxmfu4kw",212,206,172,378,54.50
"Braine2","7-aU8M4HS3AHmaiV4ZT2uzJkV2nYz0DSkMB05Vo1LEAMQPBY",219,164,137,301,54.49
"115","xxz2X8R-OAt_FaLCSGPBbuv4DepO4Nxk-0QJjoh7ED6VJAA",70,322,269,591,54.48
"shang fen biao","CODziX-BrlD5_V5ih9pOyajwHcuP9SXbLzL40Q04yES_CxA",413,79,66,145,54.48
"embalmed","rYA6dObXYcqq17mx45OTJ7VapDm0h7aQGpXCKQWwEvjnrpRPsAqjZo9Svg",248,134,112,246,54.47
"Koligno","WSfmloZnMhbXKeal_jDJjpAQMHkvOZ_qoe-dMWU5lffeXko",225,256,214,470,54.47
"NorthIane","uvvMVSj9MdbiL3V1jQDrLaRHkqDOufKOtFC5b4cDTYLTHrY",16,134,112,246,54.47
"Teemo is Nana","2GHbZYGgS2KYehCIaB1BRNeJl-oRMtbydFvfiR51UEXAAd0",185,250,209,459,54.47
"Götzmann","fo51K3wuYOdR7PP4FBwSnkdcfXaDn36DuLmReZIo0MqYGdk",397,128,107,235,54.47
"Skudsy","LEJ4N4RIJrK0kCWYhuiMPdTvGtlhtp9G9AI1dw0PqH6exfk",43,122,102,224,54.46
"Black Splendor","CdjBC8xbTYhWmVBN2EsIPGElgesun9f-F3ai67VPte8Yc4Y",132,293,245,538,54.46
"Darsire ","Zox-yVNRzE3LTg9D84PsAZGXgm8-tDPYSfq8JiumHRcPxQc",88,116,97,213,54.46
"ItCouldBeYaBoy","zpNGzCv3V2rGu-yvdDQvChUZrmQJF2IjQaKDllcA6ggF1B4",202,171,143,314,54.46
"nekoˉ","VP6vJQCwKpk7T-2nC0tJUHyxpgIAjTK-CjhJWqs04GHd6eI",281,110,92,202,54.46
"unlucky mid diff","Sf-PubEOtQ6hHPZm9Y9imHkTl2wLmtj15QBut2ZMuBdjp8s",148,434,363,797,54.45
"Kitters IRL Huby","RHsz_1qc_Mg8MD4G-J_yAZzq7UdJi3cJvfnLzlcbbw5-hOw",111,104,87,191,54.45
"erudh","WgGrfIfGZwCh-0Obi1iBoRzJ5NWY5Bqe1SZ5l26buwn9MnyW",16,257,215,472,54.45
"TyphoonEdge","7gSZhQ6OFK1VWY0qs1TGZwJ5AyyLsJrX4akf0ZskQxNAA80",87,92,77,169,54.44
"looc","J09UCU8zCj29csZ1kXzmcf064dvNNQyrpJJ4vfodDqrMQNvm",173,178,149,327,54.43
"Maxske","dby0ev02sPkwuV6akhMtMxwma4xqgwPmTLkh80pqLtmF62PSJqW64m5y9Q",0,166,139,305,54.43
"Kurosaki S","JxYUbnEklHAF7aGILYpXRCsNOSOWw5VvE1LWbVKaaaUNfTA",1,178,149,327,54.43
"Chibbie","Tlxgt6bHRUY6tWDKkySYXt8ER8DuZr8erVrXdzoeqnn1x34",92,221,185,406,54.43
"Half A Lici","2iuyNhhiAnxqW8lZA15yQ22KIp5xR9fHX_FvON_k_DvQOuwd",1,203,170,373,54.42
"Incoming Kaiju","IilXMGJkL92coAUwOxvWcczL3tbx7XiZKZOzmBqnAJVk-ys",244,191,160,351,54.42
"Cthulhu Reborn","w1u5N9Wq7af4YT5SuHltYPPhKVNJxt85oIe67mHi5MDjjUs",477,191,160,351,54.42
"shoa","PJ5KAwlTbz_X2bGejImu1C--SVpHmoxN54VrHcOeu3W1HXM",8,154,129,283,54.42
"Sarorian","ykhxJq2NYRy35BdxzTyPkf7XDJVLFe1ATGfwjmh5-OnCIhU",35,148,124,272,54.41
"KANOJO KING","PaPEGMs4L-W9hIbCr5fbKahrrlRMhb-YwNyLiabpYMz2qT4",295,111,93,204,54.41
"asdfrewq","J20NXvVmgr5AOHYcFwZ_6BGu-jUzzhpMoARMzYHRv-Zd4Tik",457,167,140,307,54.40
"Prospector Pete","Hie6UpCV9bmgVAIFUWeC3o12VF6bejBt9lda8zsI2rR8hEA",161,167,140,307,54.40
"Shorty060","hF_ih66KNBtg8zVc4K4ixKsOpTJB7bQ-qBbsuXSJzM3MCds",94,210,176,386,54.40
"Kuchiki Rukia","qOCR87vGlnvMtEKE8qUUVLWHTK3VJ1i_SqD-asr4hzRlvO55",269,167,140,307,54.40
"F0RSAKEN SAMURAI","Mjmkg9Kwn9ginWh2-cFusGY7l2d3Q__YZ9uiRn_njOBnsFeENdQfZFGxOQ",32,353,296,649,54.39
"JuÍy","0nHiZeD3Rn82AykjQuDYVHwcwgX8dteEpawIs8dPsaKRdvkq",1,155,130,285,54.39
"Dxwny","QUhTYTJOafiVtBZ60Oqh_0nE4piKRrrNbFLt51zWF836O0I",1,192,161,353,54.39
"Daiky","8-Ms_UOJLy6Qg58xkR2V8NS2o_8EhRGKhatnsBNS5-wWqwEm",399,211,177,388,54.38
"R Clawz","nSsnH6Nzk4keg3kfXfHq-omEITkbHObpBoPxdgW791G-Oz0",140,180,151,331,54.38
"RonBryan1","GdKwR_V8z1fyoZK4g2qbyhmnNo9wiEa5wXOeqz7t-Zd4uPUhLobhfGI06Q",263,180,151,331,54.38
"Butler Levi","lc1La7sOUGqzF3NdvTv6EqSniKWkaSkXJYF9_ZVdMkcvCtE",36,361,303,664,54.37
"valie","jOujBNm-NM-e3Hwa1nyJjZUi8C-EXGLYPJuc5SZiYe9SpWEAfNcBrdkNGw",133,112,94,206,54.37
"WuSkrSkr","xjXaWkciTjKcD91W1pUBveQhrPgP0g1uFO1Q9NkujFX8hmg",123,131,110,241,54.36
"TftGodBinBin1","IwvYpti6mmbcd9O_9AQHPp95mhmW-iKAiONkbaSJWG2o5yMEDEY43UAxUA",337,237,199,436,54.36
"IVameless","wm_sXPiHtwqhCvFvx8YCKF15nZ2NtUnhSEmeer17EM1sP5A",19,106,89,195,54.36
"Lagopotamus","AbFjEvPrf5JjdJh2XdcTAla7VMFXEhfzkYWco9SINMeaR3w",213,81,68,149,54.36
"wxw1999","DslzoS-mh8Vt2uEEYLD_IK896HNTFdEJ0cT5USSBa1OQABM",0,50,42,92,54.35
"klown with a k ","Qg7Io7g7ZR2-Xiq3EyLyjFvgL1R0YTTlwbQjIGt6XtITrjw",17,300,252,552,54.35
"5kep","y_KUj61iSB4fTDMDhMQw8uw7YmCB2aeRgBJDflM8knN_sZU",118,125,105,230,54.35
"Zarathµstra","_XmKo3lMz1exrgm6XFPMOJDxrKAobSeZgdAJnz7YAZSiFX9k_J3tkVkObg",97,125,105,230,54.35
"Riot Zenith","PcqYBmm_hcsBjFg1km6wxBRv3dzSynbiGcszqYe9jxcUYkQ",286,75,63,138,54.35
"ctasid","GM2TRkBnlvGEtx3m8QkhOwhF2yD9u_7oYPfMlhhiqWqlcAlo",96,119,100,219,54.34
"Always losersQ","6dkb6ZHS6S2U6FYLR9MVfGiCzq_IJrX6tLAxZ90UOUhFsyFb",157,188,158,346,54.34
"Glacial Emperor","f5ulb9wQK75B46U0dsspPGRC_bNstY582ak_aIAsFbhN-sW9uHpiPVzgpA",1,213,179,392,54.34
"Flamboozle","Spd9JW2Z_7YiIm9-vLNXlHgx5I23ZZ-oQgjJVVfB6ggun0w",312,113,95,208,54.33
"King of D1","O8DyX_ny-nPoguN4ipI7K4oLbgW6EDoydU4Xq1CTqYZaQzVyPZouV92NPg",106,69,58,127,54.33
"Art of Sol","v9OfEOGuIxmJ5vpPwDUop66E2sArixt6_l_m2-vYxdjg-volHhnaX5xd0Q",135,295,248,543,54.33
"FCL","KZ5omcPXS9nSyRWwTJArIxCVkzTtBQBPwwI7nudS157ztEM",71,465,391,856,54.32
"Shephurd","lRgQ6yjJLZXiRL2wFQWgf8wc9uDVObVZSQlWCP7k1r2gmYA",17,44,37,81,54.32
"Acegickmo","Nn51AtKwkkwVLhV-MbtuP99P8cILhPKu6ryj0Y3NlcUBLeo",81,377,317,694,54.32
"Aphelium","92vfoaB-QxzVTfw62Q0kOHD8vOyuZ1zHYMXKyrS0f599m9Y",7,151,127,278,54.32
"fall on me","O5IUz_AweH54Ae3Au71zq7fPN23y7o8CVyiKZDSJn9JVdJE",312,220,185,405,54.32
"sagje","XBW2r6dUBcc-FZZZCLmscLEhI8E0p1CE8np4XNa0sfUpjeI",214,107,90,197,54.31
"Ástral","xHJE4rdSdMoQaovWfEYgZKphPToKsCu2OvmxMugI3o6YXpuz",90,145,122,267,54.31
"Drangho","gpEnrueQNUUfvVMGF07DEZagI04nGuLDn7geEpW3-15q1EQ",395,189,159,348,54.31
"Discount Friend","_kv69U2Wdihnd9osuPvKogcX8p2d8Vkim0MNM5ohewubPM4",275,170,143,313,54.31
"pikachu92","53tr65nvIJMyCuGHIF1r1i9obp-_yiN7fThD2LRLa8SF1Ahq",93,120,101,221,54.30
"Uday","og8WSoHrQ-khdBnjIBbGuNg05jiGyypHOcFr1D3HBxazkkM",78,190,160,350,54.29
"Furtive Turnip","bC7DrwYftqfhEnwYhgz9fhaqYd_WNbh9iFix81Y3dcZiqJE",19,38,32,70,54.29
"JuanmaoO","_-UbNBVWVaO6tK0yZi8OQ_8sUpkRmdffUunAWA_h24lp_Sg",115,114,96,210,54.29
"Primal Fear","9rljf524CYs9ljCI9zoD0Sw_67qpE6RF-3hnHTDOlCRlacA",441,418,352,770,54.29
"2004 Lexus GX470","Ufl8xGMPWTTnjMUfL9gw4lQhg01NWCciBb2bg0smXVJbVkE",114,177,149,326,54.29
"no GF more ELO","JI_8hkOLowpkY_UbRlni8ZVy00oYgUrftb96ywtL_HulygQT",490,215,181,396,54.29
"Philia","jOzMX6MAVpCRxHi8Cceh6nDK8pu_ey0aetkrosOE951AwrM",1,171,144,315,54.29
"cowinator","z2qw_wp1Oqgbnq-1DDAJMzMo43s1LkZPMm4WuhC54W4QpFg",484,165,139,304,54.28
"Butterfree1202","kyaSh0G51Eds18WIPM66ZY8Qqal6Exs6Vf9XOa81aMUWmDs",1,412,347,759,54.28
"Scottland","tkkCIB1ia21U6nWk0l-bZYZhErphkfdcfwl22y4O2R_tmvo",46,274,231,505,54.26
"piss jar","IRoUx-LmdihWo0Fo2kl49FrJ0IQ_MKF7pkgq4x2izuTk1nD9",150,344,290,634,54.26
"Fakierush","tbngvUY73IJ4vtPNKfRgyo_BQ8BqnW17JkGxrHpb8nlZLbQ",1,140,118,258,54.26
"RIP ROYSH","JgQWENTFyTb4HjOMwEl2XsB-vNo7t4P63Ef9ip-aehtvcig",66,172,145,317,54.26
"Starbucks WiFi","lnjEE9EePxk5QlH203TZoAoIFMSFDCM-UVZGHfPmsuZ73yw",50,306,258,564,54.26
"wbnmdmsl","1vVXi0HqTpHxwrqsMZ0MtW_RHUcvUOrnDl02Qr3jO7Z-o90V",252,96,81,177,54.24
"gaigemingzijiedu","jqQZszfjOAPhbJtKXq8Ss2DiFvvxc3C1V4xb5pbxjFTPGC4",363,77,65,142,54.23
"Belarusian ADC","_XJ2Z4MIR8eTb2dtpdqfRBJTvbk4HSXEwFqDA6XE0OzJlps",1,205,173,378,54.23
"Schnookk","Vu4inBFA4ZY_KxLKToHfUefhTOZtaRG1qOeukeUyqO5pyco",387,301,254,555,54.23
"UIgtnina","3c72p6DS_P3dpMCwahJeBeZcGchfThLMeYWDc-OUN-22crA",330,109,92,201,54.23
"Trinkiter","iBJQLDSWu7BjK0mE_QPGabf4I36OFxEM0MywkQgGrV_bxKc",211,141,119,260,54.23
"WeaponizedAutısm","qQHwJ395gvYgMds51w_FuQP8yniQL-m4SSq7cF0q4DKQHKE",257,257,217,474,54.22
"ismiyu Simp","JrvkqeaYLg6BA8Fkdd9KEz_FgdRSe-LNeKFK3Ijw0uRVMmI",35,373,315,688,54.22
"hardbass abuser","dXyzUVsSixou9R9dHfzAHuEpQqJ3y8mlCG8ebuOJtPTbn5jt",97,193,163,356,54.21
"McDonalds CEO","5Pzkx3rTkWmun0KxOhHieswzpjdBiYFASb9aq1IrEcbtUCkx",91,277,234,511,54.21
"Fatherly","sBHezBzLc0Myiaa6oYfLyuUhelfJ9D7DnQbgwBWrnyMlTI1_",1,58,49,107,54.21
"Corpse x","pvYswAlw7A0VRgwC9orxVtAeVDiCbZEiTYnz7vrm88bTbL4",297,103,87,190,54.21
"MissBeifong","sGMbIrcY1qzjpvFD-2FveVWdxvJ3j_0e2mK6_XzDsa7ZQ1w",54,142,120,262,54.20
"TTV BamPowDraven","zFw8re31-nthjlVW6Kgya-hKHhaDs2MMmpkeSfWQHSoinNt1GWFmDo8aCg",111,155,131,286,54.20
"Streep","yFZtjtJzSyz6aojrlt0tQU97pIoqNphJMBHfvskanY9mN0U",68,110,93,203,54.19
"Katniss Evermeme","lA6TFRaT3biGawafADN6oEa9G5F0vvcsVcNdojDwMcjcOtc",364,97,82,179,54.19
"Enndme","2NSDGKxjKuGMJRNishjdkQrYoE5AzqgCpHz93O6Ts0z7hYk",17,233,197,430,54.19
"Arcaris","tvKfGwbnZlvI2bUsyNCyk8PP5GPuXTEWRG1yTKVIHkbCSSDfMJXBtdXSog",155,350,296,646,54.18
"One Error","cFhhBu5EZKpSKzLG2PoFQGHDgVTlDAD3v6seu953K5wu7RE",224,376,318,694,54.18
"perroman8698","9W7Y8mOykgAUHJA40rM-NrR4fY397qq0pvv9tsrIlz21YUM",332,240,203,443,54.18
"Sinnyboo420","EbTwGckCcZXXJQNIoHcQ3BEzMt-v2GUKZExTIUKo1IKguRE",331,136,115,251,54.18
"TSM FTX AnDa","lcoklvldPZZyizSF1k-r8PW9Rnb7nEKAAhRly2nQjHaK0Eo",215,182,154,336,54.17
"Rikugan","LZI8y9Ms673wIqnPXHcvU67QtidxfBqRt0axu1EtzZMu1pk",1,104,88,192,54.17
"Mickeyliciousz","7UNcT04JXhNsT6viVLb0fT9UoKAAuhmEHNDP7LSppyCuBFg",80,221,187,408,54.17
"lliiilliiillliii","3_U-lGJjO3DqhjLhHUo3l2vRoa-AA_t8FD3ao99EwjaAHojVlX7_QTjZ9Q",2,338,286,624,54.17
"POOP POOP POOP69","CVDuKfU__RUBw04jcwGmePirWCKH0BUXGFAHKilhuTEDAhc",151,378,320,698,54.15
"Cindylover2020","eEeSozLLRUADMKR95ygsRhJKNM2eMZyM0dzr4To8voxyXyFG",0,137,116,253,54.15
"cheesymuffins","yYr_H_DNeJKDEfTfWkMrP8uDC7PqmNWg_xY8kJ1JQYBws-7r",255,352,298,650,54.15
"malo melo milo","_Bf6GEUoAVbWpG90jid8UocEojiFdVb1p83bNtCvcTMVQ_M",180,85,72,157,54.14
"haseuhuehaeu","puGbXoQQT7K7LIPGPEby0FFA0S0NCMDhibekrb9c1LBdpfY",0,72,61,133,54.14
"Jinpach1","zx2PrMjzkqQkgdx4Em4AScigJqIMhCa7VbvPgKxOLt3UsL4",152,203,172,375,54.13
"LLAs future","VFoaA4xIJovSwxQsuU_XMgEDHOC2NkNh8_H-bhrl7pnWTVPb",62,164,139,303,54.13
"Hairclip Girl","xl6Bg3jDGwLoixmRr57UJCSIOAX1UQDflP8O5DPnKJ4--rI",1,177,150,327,54.13
"ImDrunkBro","bO7ODSxP87iNW9DFLrPH5hSDgojOTSdIKZOgviGSvzuJYOw",316,433,367,800,54.13
"xiatoub","i3hmz6sQnHw9H6d0Rn8CaPq2fQqZ9Pb18im5Uz0BSltvYPMb",1,184,156,340,54.12
"TheCoIorGray","oCdo-KC_qYYnPKVwpbq6Vg9PQRxy5eadVIyEN5JyT5H73Lo",1,151,128,279,54.12
"blue612","vW4Z2HMFvfTJ9KjKgutS-Ocg0G2CYFGJx82WeY77S1-Djjs",164,46,39,85,54.12
"He Tilts Me","OdEx8mGkgImeMtvVljAz398k-1d1qDqJ4qS2GUXn6BN5U90KBFqLWG3HxA",350,243,206,449,54.12
"0ops KeY0u KeWu","S6KgtLWIMT4se3cA0u-mOWs29wN_7b5Z1V7lb4cJFBF9E50kzuyywx8v5g",1,92,78,170,54.12
"Halid","bVuNemghwK7SuwNTlUabPFLtwt-9LWY9P3maiRY5x1exWuI",274,302,256,558,54.12
"VX RankFast","QNw9mfVzm5bWFJFA05B-WgD2Y5GrdKybKE4laY-DAyOrTtM",298,158,134,292,54.11
"Euna","P_L8-Fuo7fJs_odmLq1k3TtcZ98M8oB7QBbiJi0vE1SxW7w",93,198,168,366,54.10
"wont let u go","P22cH9TQFS4L8p1wSY8uKLzQWMuCDI_D15XGOIJc7Fn3nzAp",50,132,112,244,54.10
"Claisa","is92XfMFn4uGcb3ZOyi7tONMfhAILtqYPUWHoYEWjudS5rI",317,86,73,159,54.09
"Viceera","EYv_FnwjmimHyz6d7sYZMOwCyYztXpC08mfmcZWxTb8_Mq8",182,53,45,98,54.08
"Young Ducky","Ph--sO-_LLv1tGT5qljPQ6H7kR9uwBDd5z9blwr-nQCfPRM",273,192,163,355,54.08
"º Młńgçhûåñ º","Ss0D1pGMTzkJiHmT0Q1miK55vLjfvVOepFtd-7NxJ6hgEMo",34,106,90,196,54.08
"Thit nham me vo","NwEedG8Sx0oUESbMCR7N7fAAusSrIE4bXCNcyonIJPkGcW8",264,93,79,172,54.07
"Spin for Penta","Wg6j8hUQqI6XNkqw1CilA9AhgVYgEq2Y-1sSVjlz5atVQn0",266,73,62,135,54.07
"MacroMan","Gr9Z3JCZIfen7KHdE6ABs3h0Lgm48Bodoqrh15bQlF_-T_Y",150,618,525,1143,54.07
"Bebe Princess","hj3rA3B1gr6T2TuIEws9q-gDGbEtG_fy3j6EcLIqVzqKj6G1",2,166,141,307,54.07
"eRa43w4","vMjxAUUfWLw4MmxUyI_MfkHb08m6_xn_WIR1WW-Iou2kqh0",347,219,186,405,54.07
"ReformplayerXDV3","xCzFh7gwW_TaVBQvdabryFs4aPtSzMu-wWsYFdyZbXWea3w",76,133,113,246,54.07
"xnxdhlrs","3qrm14J7Gvaow1myXTcIWwHOly5cxk5teFXB2BoiIkpAzxuCniTPKkboBQ",259,333,283,616,54.06
"Porkys","qafjZ9APRC-qikt9kI20x5oLdfz0dFiKjiDzG_9g464hU3k",358,313,266,579,54.06
"opqwid","2W7g8JsaqIk9ivMMzP_G0Q1x3LB6ntNtNkxeaC2ODF49mTg",431,140,119,259,54.05
"Bigfatjijijij","uMq9aM_mq5jXadsbDn_Ywdy_gHjxx_UyJBfL1vK90PKOq5o",319,167,142,309,54.05
"No Backing Down","DR204_IPcqPQnMSZPCmPML5rVorZaK8b5bU2Dta7y8uS2AI",74,320,272,592,54.05
"02 03 29","aq20uHmfUikzMuT1Vs4Ru92mJpv7e2twKJwvkw2KELTSU2uFYjxjmH3mVQ",9,40,34,74,54.05
"Thats Cap","AtMhfPAfd8jriEFuT0tpg8Y8l0przH7bTNuIYPPpwGQL-qq3",81,260,221,481,54.05
"Swordblue","UIYBVXGIdz2Tt36sKgsRd7r6s0hJt4KYFiin9YDaiacmQbE",401,234,199,433,54.04
"Cartomancy","FX2q3f1iR_MDt3eY6TqGhkwqtDfOUC3UPWOE9dTxoC0z9BrnDcRXTpWeqg",87,107,91,198,54.04
"WX zGxAY3ZLlFI","UlqpfGIQe8F8lLy74Ch6bcK7wDTPJurr7dQDbDdutiV22iw",223,114,97,211,54.03
"Rose Throws","EzJNXJYzrpQvQBYXaiqYqwH2_F8OLYh86RwjcIPmC-Jy53o",174,315,268,583,54.03
"Warbil","861kzMr6gMPoa4vxf5FiMsXr0Poh7PmCMwldnH4Af6Zy4i0",1,47,40,87,54.02
"Little Bear Bear","o3oGDkgS4U3IbIgg8814SHL8Mvpr-l5AWTR2FwzqbHaIDYo",319,121,103,224,54.02
"Łìght","XyorTT_RF0NqE7eFpEIq7o38CZc5SgUSG5wvIi_pN5ck8zs",311,148,126,274,54.01
"ShortCatlsShort","hac3GsNoyhwroIwhPTkNLHwPkJXmtTGez7kZD28XBxjWtpA",1,291,248,539,53.99
"YasuOrDodge","AeMIYFXvx55HvdzmeL7ConbEGzrfxkrxIM3lOHbRCwfTdWVd",171,88,75,163,53.99
"IFailedUSaItu","9bAJT1V9RFyWg47WvYuFPg3YUqFTNSy3FWx1SugexytK6Juc5rpBTYIBkQ",262,88,75,163,53.99
"só queria amasse","potbz_87nhSpo0bhjcL8diob9DB5OrZvpRAmgnnoLRAds51fEz_gNw7q9Q",105,176,150,326,53.99
"Everglow Niko","UiEZwTMZX8EPGSyk06FPlmz79H7AQMLtIhnB4fLHOShJhRk",33,237,202,439,53.99
"CR Dotoripie","ucixA-GFuX4DWJYPRUpwToUG18PBDZfd0Dn3yP2Ub96fcyw",168,264,225,489,53.99
"Moofie","QTl_zrp9CPvzohovliya8t9a-reyyJyzEqhZoJilB2pmqu4",53,88,75,163,53.99
"s12 mid king","MqpuGvdPpMEr7eoefCRHQEhi6GVTYmzExISTc8xHUVtORQiPAB5ZJWr6yw",0,115,98,213,53.99
"Sharpe","BWRSdK_91NrFKZREAEvobsgbwT8ElCuc4aKMBLEzIwzxDRc",33,61,52,113,53.98
"inting chiners","Bb4PNW71jT_pZjMfOVPEhcyihcTw2Cv0q5V2U4SYcyh7uAA",32,163,139,302,53.97
" Vºid Walker","Mz4DQXQFyO1hL2j-gmIkgcWzQ5jHRiHvxeU-g0XpWKEvCjk",200,211,180,391,53.96
"Retired Kled","VpNgA7c0qsOxYKrMUSr-iHyC4zz0EnFUbj0Mwx30xZd6QZc",428,177,151,328,53.96
"Chílly Willy","a0r8eYIw7Nv49oUwpPpoCkXTqPMllvOCjaypGYiEh_NfraeF",397,75,64,139,53.96
"TurtleMaster","Pf_jYlHfGkdGUOYeiMCOow9MOkLF9SFC51xMPu7XyF9pJ7s",148,150,128,278,53.96
"BrownRiceGleaner","ddhBtJr5TdndITZBTHKpNKk-8GPmkJDdAC56EH0P1IedZHc",364,320,273,593,53.96
"Shang Dan","9CIxuKZJN83DcstMWT9QDUITVEHrfzA4mLxZaPZosyOvVJ8",141,123,105,228,53.95
"Yeongjae","3aVCOh1i9ATgjUSNzjdoJ2Io2RE632vo-ZYl6Yr68tcxO3U",281,260,222,482,53.94
"Daddy Cui","1ujO0PqaZ2Up7iz6zTGew3IKoMRmYmREC8s2eSvVy4RMIuk",133,137,117,254,53.94
"Nuchiha","zgf-jQo0Abzz4GafhDMIf7BhOBdDnrA66y_crcRt1T7habg",0,89,76,165,53.94
"Thandemic","dSFQ42LO_jsRx_7Id1DaTpzFqQjXAiVHaYOTcAnRipQ6TJ4",176,274,234,508,53.94
"zxqe","85HYgH3l2v1o-CK5QrRM-f60DzW11DV59OB2EM6D1hKPZz1wAxWGyso-6A",258,89,76,165,53.94
"PingSpam","STnkXF3GMzyms4mr-9oDTbYrdZpwp_LGohM565qprxmumU8",39,219,187,406,53.94
"Hoptech","ZoRppGKMpaH4B_d68V317V_e0f6lnl6X54mG5didgf5JIYg",106,192,164,356,53.93
"The Huntmaster","cQAzjkPDQe4YnSTsJQOfHXz4YQ_7Zs61CBNaIA3vRqRGsyFUNJUUo9Of1w",466,350,299,649,53.93
"Syched","PHhhmQgBxiN3aqYG5uG6h6LYHFr7C09ewB9lSQRiii6VITw",85,192,164,356,53.93
"JNNE","hmCzfg-QYbDHNsua06QHF8N4tovUlK0cuXHNa6JNUfxULmprO1KVFbUuWA",119,96,82,178,53.93
"RealDarkness","EdveE_L1EewhsfJ73Ek_Xi0qe7ahqsc3qbIV14_-xbuCCiY",107,220,188,408,53.92
"heartpulse","dK21A28S_raG9DxcrGYeOSJUocdbQp8IrPdmiSc7FsO3ThA",458,172,147,319,53.92
"Kdrama","8ixMemKRstza2AG6xBVToqwjgCgTe0slbf-WzjQzcK9i70I",257,158,135,293,53.92
"oy to ne vecher","SxZE0cz-IZUEMGafcFy5beffiq2yrYBCkLzEH2j6Ln9SFdHb",119,165,141,306,53.92
"Rídge","06wAvJkSonT32QChFMuvFA29nlRHooHfS5nmg3si74ybDZQ",1,55,47,102,53.92
"Lavereell","Agn9H7SJ21A8XvYtvzlsIDOCXMkjWuovZmqoopmA4trkP3GI8rHC_BDulQ",75,138,118,256,53.91
"CanOfB3ans","6Q5FQV-_yVULEnU5teoIioP9rV2c2zqdOk8ml_BJPQqLxYzv",36,69,59,128,53.91
"SEU Kip","tMoxeIXVTLI1NLzHpj-_7fmehBmtcEe2jtkUv3RgWookXPo",303,124,106,230,53.91
"Special PIayer","ON8t0Dva1lyJRgrbB7Cr8hn2wQnpxWkUeO_vmoqfHuGPkAQ",261,297,254,551,53.90
"Aiksa","sIWxbl0_DmcA6tnV5AFd9uaejeo3n74XVorXiqKdEQYMD-vK",304,221,189,410,53.90
"Shacolate Box","CeghlTqKiPcs2bUgOhYzy8yczQMoqAHmXdOnNBfwOvYqVjo",1,325,278,603,53.90
"RIT0","5gmYt2PFjRHkKrw_HQuGpbxgOLr16czs7Z_Nm46DsOAyRHk",1,242,207,449,53.90
"My Angel Ornella","8xLg5l-DWbCZCTZ3hup3Y5ZfS19iFZoEuWvWMY91CspAclkx4dWLNKgLzQ",254,159,136,295,53.90
"Trey Lance","vSNYDdJ0auWagiGKGjCQGwgHR238TjrQ-koo-ad2AcGEd9M",334,83,71,154,53.90
"Redsaward","QArsiyxLR-EmX6kRn6XzfltXeg18jbjV3YORcn_1gNseqs0",424,242,207,449,53.90
"RoadToProIdol","NeGJHYCPoEtVCmeOu6qGXG589SbRo_LwmITZ0aVqOtaGC72jNEAf4j2LTQ",34,152,130,282,53.90
"NBOniiChan","jyBqOmXn1l-rgOqQZgYAEEOX72keunOwwNz2W8bulOAhX0ANoTi-h7PYDA",200,256,219,475,53.89
"9REED","uIiEOMbI9DP3ALNDbtB4_nFMVi3_oSNJNNg3h60t0VhktAJrH8ScKYethg",12,180,154,334,53.89
"Scibbles","hypJ0f7NbZQSsRHj-oTrqadNq9lcmQq0G5Px6_0te1mf69Y",346,173,148,321,53.89
"ªrª ªrª ","1ZLSmXsrrzI82JAKc_87a0WVwSfJ1gTwHmKj0gchJkUWHGzw6YL38s6Qrg",436,291,249,540,53.89
"SodiumChI0ride","5Vi3hMvYjxB6abfrquLXRvfBGARvllkc_4auZ-lThtDR-z9N",101,90,77,167,53.89
"BINGE AND PURGE ","y1f5-QnmhxbkqvusY4G3wbEhPjrd5aKHnBFh_PHfqDk0qX8",183,111,95,206,53.88
"RETCH","71njtLMyd9HQJVv_CEzWGBL7wONuPQtcG1vFDo7lpQtoNckofmxPpmjQAA",0,118,101,219,53.88
"Young Sinatra 3","uydmotHXUJpSz5AIC9cYsShKIKhubCAPsKu_fS7o9EGDjw8",454,458,392,850,53.88
"Lev Neos","vDNPK15H46kI5HMiH6_V88m5abFQGfZPO5wFkq0vZ8Ylq04",49,132,113,245,53.88
"Heinrike","_NPhShWynPi8dQlO0Re5UN9EABCZJQeJozDe5niTD4Rl2A74",254,250,214,464,53.88
"mossy margiela","V5RpNWmMjM679CKdYGIgL4_Sb-ruiUKiVhAqERy35wTwRts",14,333,285,618,53.88
"goldenglue","bUpX6zYdHJsSsxMregzL3-_mSHdpw7t3toeCgyg0wo0IS7k",277,118,101,219,53.88
"CHADTHUNDERCOÇK","PozwsTSu-Pnwxo4MFWCMeXiMXliIwLiKkOm-V0aH0XbHQ9Ru",42,174,149,323,53.87
"2MrOrange2","f0hZ-Motbo56TuNG2yS2NspqazZLEuMQVyHzzaXhFtebA2s",287,195,167,362,53.87
"SANJl","xUU5iImSX7KJwwwO7P3uLGFmsG-109bf1F7uEcekVDW4Nssc0wDZ7qaRGw",1,432,370,802,53.87
"xsxsgh","R8N69Ff2cK8CCLUS3529ae1lCAqymWpzScb9TTiVXGc2BeE",1,167,143,310,53.87
"KOR YongCle","LbrSgudGCiWB26ddB4dR-uqNJbY6mpNPLGYuadPHbzTxma2o",0,230,197,427,53.86
"Gagney","X5fp3NCqj1TDiwOr7QZ3sqocgeVXhGDn215TKu1CLYD9nEo",97,258,221,479,53.86
"TreyV","n2cgQMn6U8_ridJ3mJltRrOLIsHSRJWTS37sRdKDUNlRm4I",300,266,228,494,53.85
"XueXue QAQ","4pxde4S44bjqmnG0_dkwQi1nAQB53vgO6nuUKDZUj_LQJHcQ",1,308,264,572,53.85
"Edel","vNB07qDp0m26j9YCtc-MJYgHMjr0kN3FTvM6HfMIQ4NPemM",81,98,84,182,53.85
"I Want A CutieGF","So4k_P40wMDPb5NSZKB3VcYTK3MJNt0uXP7J4qTSmuxHBI4",230,238,204,442,53.85
"the ghost of D1","JRio29IvqKB0fgVOL5dSo6ltH1XmxBjIQlHOfveOf5b55q1U",19,91,78,169,53.85
"XxUntitledxX","27SITnsOiLEisP-5125o-42wvDdSpFHtzywO0jp8V3We_EU",173,70,60,130,53.85
"lrx1000","GnwmBYQkssl9XnRF4bEvxYvv0Bg97IwtIE5OvjjvUnLjpfQ",32,112,96,208,53.85
"Inuro","kUgeZyiM2K_sIbO_ne7o042v_THQzAGbolLptJh-ik5jV6Y",30,91,78,169,53.85
"Elementilist","LfCo1aPCfuE-xEyq3T9BW8d37wOYS_FZ9XUo-DCVyLvors8",115,182,156,338,53.85
"Hornet Protector","l_cjnEQ1l1oI-TAeoO8qoWo-5P7nmSNpCovr3BtPf4KUKJQFHclE64-kOg",109,84,72,156,53.85
"Bard mp4","bJy0OCAyyUTvAjGZ6ycekSQpj2uB1P1OEuE8_l29tIrc6gE",280,126,108,234,53.85
"Bubsyking","A3Gnpd1IhDPynzsIbKp1DG7CHrOJZkZMR53Vu5inh1yxA7U",17,315,270,585,53.85
"Nightsaw9","sT-9re9IG0IHuku7NfJNFjMKZNLtNlEcOVe8iifw8bovuwo",80,231,198,429,53.85
"nGiles","CQu5yN1sUFZg0FbPxbXlW8TYLd94BQ06gZTrPpxxv_qSg6oy",87,231,198,429,53.85
"H0ChiMinh","CpZAtECrSY5vkppTOaVXBdqKynAQJSsgyle2632C9YaAlTs",16,449,385,834,53.84
"not13","lQ7Y_6KxVPH9jHK1BWYoAW_jTcuLHW8GX8Lz55clj_SlYSuU",106,232,199,431,53.83
"lmHereToDunk","eA--Hmr-FnVvLblAqvblzS15zhfMzLeHfmVu5IfXoXQ0vKk",269,520,446,966,53.83
"The Village Fool","8vpB3MOyOayZyGFnD-4PMbhfEs0e45lBSgTgZYH2Km5N00s",1,401,344,745,53.83
"Jexorx","1XlQLMyEO37U4c3Xt5Ji6ncX-Rfb2tXWbJomZH4RW-MxTHQ",57,289,248,537,53.82
"Jean Francois","WJxpQs0YE3dISDG5SmyB7p23Qm4ZFYP1l2QeM_AWzkpt_yk",252,219,188,407,53.81
"Rod Nez En feux","zvIqAoQfrNHNadFiImy-PR0ETIFtq17hq3O_a3_f5ncFXPqcU5Aq-PPv1A",24,212,182,394,53.81
"weed hero","hc_1SWeyNWxGiHTO0OykNVtbnTi_uFUV2ARNMjMQ-qXrlmY",202,106,91,197,53.81
"kebukeyii","hSXxJZn778eGqi1Hi-5db2qfsJV1KYqgSIq9sFpTOzQEe88",0,120,103,223,53.81
"Jar Warrior","lr8R_MGZoAt-nsLBhak5yWO3DE7ftk8ztxI_nlkWFv83ClA",145,177,152,329,53.80
"bei ni bao jin","QrNxoHYYxvuwpSzEAwJym05L43CrtJAHQJzz6Fl7zREs8GI",353,341,293,634,53.79
"BNastyBackAgain","U9ToGR7Rv9vvXc4AJyebzpc0u65JYKOX2iM3ufOd9_2bHyBu",272,312,268,580,53.79
"La Chicken","rBGVZWxGNwBUi4v8yYalrS_XYWJTxD4NtUWmRuTxHaWW4MQ",169,71,61,132,53.79
"ıdol","Xcpws8_x2sG1bM3SC2WDfOLaB4ndCcOrccXGXMdZRbBAapk",37,178,153,331,53.78
"Faisalll","go5M0t09n2SaIkz25w6vx_COn7y_XNNejpR7Sx5c6Kus0f9x",175,306,263,569,53.78
"Esmönd","uk_buklLobw2RUjQmmxsmvZxuKdyvigh6_BrOBPVs5IrnmM",0,121,104,225,53.78
"25 hot","1-rm4_upRT3XUTZKXkNUZm23OQ_D3cOHBKPyGnngpLdY1pdO",329,114,98,212,53.77
"Im letting go ","cwOQMdw_1y2o7Rp18E-XHN3hPbX0c2t02u93EpN3ESrcB5E",104,57,49,106,53.77
"mcqueen69","r0IEMDDlAZ3lt0iY1WPxfTfRAH8Knv50wbTyVcvkzh8nn70",105,143,123,266,53.76
"ramblin","nrGogY20fVeTUzAzR5w_T-kefVNfJe22DL6lh9VahiruNSE",294,350,301,651,53.76
"TheWayTruthLife","jFehfIqVStmFMnhk3_ynznoDxQ-oIDwD6RPiZ43-4bOXcd8",84,265,228,493,53.75
"Izuruu","H7XtI3Tp69D2-cGH5B3PaymToVfr0nu0nhjkzIgIbt0yNeA",254,179,154,333,53.75
"KR Darius Oppa","9hzemYhWqqkz5TTwOHU4PBYGwxytE8S9OfQOmR0RkFHCJzk",204,351,302,653,53.75
"i yú","U7r4dbam25fSJD62mvmFC6pPgNzqlnXOGifrMcp_oTM3eT8",198,222,191,413,53.75
"Sanguine River","YMBGCke-OIXE3V_N3T3b6dQ5v4pkYFeHcKEIYVSTzJKBawc",248,179,154,333,53.75
"EnSaneZ","qDqgGYmll3MK2GVC6Og0aHrd46E3cqZiJhMZjjdMMdPfBxS_y1PouVpwkQ",253,194,167,361,53.74
"JE ANG 2","MVoSsQam8p9AHF0-l9mZwhDai8GlxR4NunMqcZnBdV8jVgub",126,359,309,668,53.74
"Iaceration","nQeiJ3171WdqqS3wpk2fAWrvjus1afZfig1MQI1sH2wFuTQ",91,79,68,147,53.74
"Outplay","1Y4NRY7vRqAfPUFbobAUKnAncAPyIxSy6M2OatnIpVmNc_E",190,79,68,147,53.74
"Kuothe","3DadAI6IwixY6BVAANBV1qqvyyyux54nIFDZ6xl_L-gWGtg",14,180,155,335,53.73
"DK DonutMaker","fB5uyecRX3cN4DeLiNpzlBpQm1eboZHXcfD2akYrlaPv7-o",68,439,378,817,53.73
"Wizdid","PMpf6VeOhXnVZOg1H1j3tZVMNdotivUR9gE9aCg9rJ-kPKc",308,159,137,296,53.72
"JaggerMas","v3lBzZU6xGvT8pHJ50gONhu-FNWnisZKu8_SfDYXyMSlKds",1,101,87,188,53.72
"hahah idiot","-2AQZume9LoPhzPLfY1MaZ_DSIWryFp-0I7TRQHF7ixWzuc",1,65,56,121,53.72
"Rawgnar","L91x-SDdG_ZErtOMtLXMx1CnXjIb6e37e2JqEgce9HGuBrJtxU0YsER12g",73,268,231,499,53.71
"Neonatal Nurse","ttX7q0Dp9xLfEXJeY-dXCp1pQmqAUnKKtW9yLLpMro6G6TAlqwD8Jr-2OA",67,282,243,525,53.71
"DendyCheches","BvTquBJYaDWSOb85jwl4x--_90NtSWbaIMo2C3vM3kWrbu0",363,138,119,257,53.70
"mentalnirvana69","SgGaO7J4ZPOoI16oSPnw6ADJSwrGQjWfSl8gXkx7-73O9MmZ",145,58,50,108,53.70
"Águas","tHgoNOrAsukeHJ_C46ukFPjT1qameJPPLDMMI0rB8syErps",34,320,276,596,53.69
"Yîkęš","yssEMUBi4A-lZ2c6PjDtj0jUww2rDbLPDTrEuZ-eUG8nbns",56,131,113,244,53.69
"Mundo the Fourth","0duaJSm37BGMaRxiQHV5un3xIfdIx2xo35fJb-yfcL9yoDE",53,226,195,421,53.68
"DespicableMeep","R22LZ_aKpGNJhnqGL1xCBOXWGX0_03KsoaTuOlbJUXOS5Wg",262,365,315,680,53.68
"Rakagan","HNe6xAab88aivNDJHXb8G5ChmRDa0XwY5n85Euh5p6IrCTk",82,102,88,190,53.68
"Ç c lover","j0g2F9VoRKSA1ChoPX-FRkQqmcQqIAQ6LdgpsFy8OnUJ_FY",85,73,63,136,53.68
"Deﬁant","TCg-6oKuEZbQokiL7VirJL0wLoLz59taDxLzL_ce1Ybjvdo",66,263,227,490,53.67
"GuiNoodlecake","rosvJmNzgq3Ghfmfl5t4Z4OgL0LNyDTB2VB8N1SQA82wStk",17,366,316,682,53.67
"Viv0","cgDR9fOyG2JmLIDJ_4dSRrpDRwJFUVMoj3ssrLCpsQLGMwU",48,95,82,177,53.67
"From Marz","hIT5AFdcItadlqQHLQzRtUVd8xweBPGDMAotmRIa8DB432cxvEe993mLkg",342,88,76,164,53.66
"Permanent pain","CjW2CSfPFpftaD0xUlBd_nu_-huA6PYwX0LPfIyBWdx2DxI",14,147,127,274,53.65
"SiIv3r","CTzNOMQdf6IuHOCY9QzK48QUhZgMdViUCUsciS_wBl3C_HLz",338,331,286,617,53.65
"Warm Bed","Q8DStCo0Vw_qex0dZNpwQWxkHYsAEKeG42jMUJRdVtSGw58",39,345,298,643,53.65
"ShySept","d5pN9b6Xfc1tLv24OtUKgUq3_KQ_2HZmP-CHSXBEiw0Cl9U",363,147,127,274,53.65
"ˉPunpunˉ","qVFfry8ZP1nqZs3-oLflcQhhOOW4oBi3zbE5lVdrJ0C5iw8",352,147,127,274,53.65
"Lillia Hoof Pics","jRuqk8SWLEMZCNu6_YxTk1BbkvTdRNaArQPKa2SrfmcbIDHFvIMevhbUug",247,59,51,110,53.64
"Trey Support ","oklhVsdI8TjxtlVh2M-6GxisPeQT3ogJj7j8g6BJOTx9XUw",30,265,229,494,53.64
"bormeleon","v5YuYXhdia6LBOIOvyPoD210oj8hdJ0iiKNEtOKNZO4108o",308,398,344,742,53.64
"Lucel","Clprxvd_Ya4e9eNy9gn4qDg0xzoSCOSlXbeJ_jJVgSoDApwqNZJcNkxAJQ",169,265,229,494,53.64
"Not Hans","pkraAnrA_FCRjaEkXDKVC3_Bocz6-m5vBzCpM85r7ojmp7UU",372,155,134,289,53.63
"Iichiko Oolong","GGratBIWVXyaxzeq1Jk0AHO_68syd-EBNHhcImJ9NGDQvdE",37,155,134,289,53.63
"lan ling wang","KyfeFPWzF6-j4Oj91yMBV68ucuIH5MZmwqKs8UyAOjGX8zI8",308,207,179,386,53.63
"mamacoco69","XEPl4vmGfXnn7PuBZ_6EuWEyWX89M9Z9f0RNG05MxJyJtZf64d8Szd45Cg",0,74,64,138,53.62
"zixiaobaishu","hVMFCMlPPbnuKLHVZVoZMYV7FIA99gTccoXxwl6CdZakCUui",336,326,282,608,53.62
"SApanther410","YLN6Yy261Ui3oVI0arGhLKjbn1FmwhSXd5qhda5DEPBVwJg",477,296,256,552,53.62
"qqdcxjjgbmnfdwtl","7Vq9LG0ugZELqPAjRAYCqYlcxcxHhqhQwIlGKVnZL01muNzkaupEAW1XzQ",318,245,212,457,53.61
"emo game","oXHvecePgLi3OKqd68xSVsCgtjdoAJW710XxC-nFcN8Apxo",475,156,135,291,53.61
"Kircle","7WLyejdG3-izrqZCjcId-uzriAzUVQwVjCX-xeTpAtZeo9A",1,245,212,457,53.61
"never prism","C8p4xaluWU6nZIRVOxn0vClHw4xHps3IN8-nMcFAdSkMMes",52,149,129,278,53.60
"Mazee","NiJVqSL77ooccv2pNIOnlfgNq8plRzsNbc7DUJDJ9R0nRqqQ3wvyq9IfPA",236,350,303,653,53.60
"Ashwın","UjBGV0HGG9Z2TKwC2MUgjHXxBq72l3UanUj0j3a_hpoGgV0",300,283,245,528,53.60
"Gweiss","kiOPJDNYLdhsRR374GCM3eXiIKck2g5KSJCGB3AFWcutLVw",414,134,116,250,53.60
"Pyru","J1WsA9tTV93DBhBaKkQGy7IHdH7yX1QRFDVHjSKJ2ZEYhuw",60,149,129,278,53.60
"SuperIzy","q2iLloSzmF-fymKaqKeyYzo9wZmKc2RiWXWEEPVDqs1zeUw",0,119,103,222,53.60
"Thomas Wake","BeI3q7Tl5LpMI4HqoxgbzaGcY_93V-BNYfYYJ545T_IbFExY_tM2fgQE_g",396,82,71,153,53.59
"Randex1","1ESDTLGZ8ObgL5-XyeNyeEZKiXd6ixtTeMjhuXkjvZn11jE",109,127,110,237,53.59
"akshually cringe","EVYYA5JO-3eDhamODhoz9No5dvdEjuldPJKHrmEGr0INcb6nrUdY4GUVIQ",249,172,149,321,53.58
"Zifarmaxe","QVPf5CeeRKIaWSqauOoqW35g4jjGiQ5XMjWjzDVFEFxgLPU41SUXnQIYfQ",190,232,201,433,53.58
"302 ionwa2go","B2bk2dL5aPBxjwmzg65Q7kCrqB7zDQNx1mQX6w7bMfmd17Fk",93,135,117,252,53.57
"Pøker","KuoUOkFz5DzYl54VPyBWGZzZ7whkKBFXrDCMy5vMYn8Fcj0",191,270,234,504,53.57
"EiffeI","1AeKc-7YJwaYV4Etyrkt8E4HkSd2Da5viOe4cne4cZljPAM",86,105,91,196,53.57
"Ocallinnan","s4cHD83WQlcPQFE17FF8LSO-o0Wd5zWrFqoOl-tql3tZ5_ht",129,323,280,603,53.57
"Dream Dragon","RUCQ_t2_T8Uz-ADdsi1O_BtftYg5VlnSsYBrh2mHWgPmJuKku83yhKPsIg",1,323,280,603,53.57
"Bu44","uWLytWUSi0ek2-fs_hJIaeJEACpe3NWDULHwPHcZjjqF0-rF",244,354,307,661,53.56
"Shafwan","UIq_j_YGf-cUyEq7LLjH_eweSPFlvpRupnWdoDGR8kzWqv4",167,218,189,407,53.56
"gpcay","oVLV1qhe_YS-ru4C9qr-6dS7A_nJY6YAd8Wp__PAbvifddqxFuxKx-DWYQ",272,301,261,562,53.56
"ERISYAKUMOEMILIA","35NCogoMqBRwBMbyNa3idTy56YGDxb8NTXKDKcDMCvTeJ2Q",255,204,177,381,53.54
"a1cu","5I59WESkbwbDGpjuQw5tL6aTmbMIk0QHPuIbdVMIYO8RusLp",360,212,184,396,53.54
"Skyrenn","10jv6wEOC7lmoaaSm3EjQGqxw6GkL2U82Wn1msG7-ygRDnA",65,136,118,254,53.54
"CripOwn","TvWmb7jYSXtg471gATDKzaC98Hv0w3FC2KtX1aIqNlO00pI",0,53,46,99,53.54
"MEECHOL MANIA","W7Tw_PSAMJs5QVV6SDQTqRrKXoXM4kNF0itWMS2WPwFNN20",405,182,158,340,53.53
"ShiLaiYunZhuan","ACRN14OEfFnhl2pGxaQ-hcFL2StFmhaWiLlUcJ_wDgBG92k",145,379,329,708,53.53
"Trundle Top","BFJraa5KQcymB8UlALb_FUL4gbsJuXwze1e-YgMcGxy4gwk",416,152,132,284,53.52
"cute mute","4HaRZRlShGNbzZXOH3a7pRhcMtuWT1VcnJmzFMrEpNVe",0,38,33,71,53.52
"YouJustGotJuked","_WxHhbcdybaiLzBknc1BpgHw9ePAJuhRZBQI8ixXy93dFmQ",78,114,99,213,53.52
"yipeeyahooyahaa","x2XX7kwbjRB48tJiDJBkjREo2pqw1aGDDJCAMSdBn27Wo_A",180,114,99,213,53.52
"ScrotieMcBooger","YTX03PJV9G9gDFIY5V08oRoKPXeCkuoAuq55Jn-cSjLekyLQ3r-SLGN8kQ",0,61,53,114,53.51
"WickedXJester","SUnOUYe7lZZQQMRoBo796GuzA_L2q7QQjG0y5dHm6jQKPaE",13,191,166,357,53.50
"Gerrard","FwDMjNXtlaanf3_Ckv1G4SnCO7JFkFHClPFYkOzHLGrpNRA",101,153,133,286,53.50
"richard is ugly","rp8VikGg_7IE_sLHpP2HRa7BPggCnTtXE6r-DkLhLiMVS4A",145,107,93,200,53.50
"zmz","SpAXJxYtua-mOOaRGWScYebgn-GyieEVwr0V_S9uPujQSdp6",348,107,93,200,53.50
"Jaquria","SFnyovQEIyKKgSk6gkb0YNL_0Np78P-7pWiZFiTtbftHDG8",246,191,166,357,53.50
"AyzYezz","Pkzb8qyT5PrKmodYcsPQrBNIGChxE_yZUKUBUP66FGmPA3M",113,84,73,157,53.50
"IoneIy swimmer","U7dNVXYbYB7oSxdWMcln4OLaDFE0517dl3hRmchEshp9ZaE",150,176,153,329,53.50
"Schvi","0wXEktYw6xDj8LPDeAgNJli5Uk9F9onnTjkHIxFjxbi-0WA",116,276,240,516,53.49
"isigzqqg","dyXbDacNO8WbVOV15ahZh2INxUGLrLVv0XWnn300q7vv8Ktj",58,115,100,215,53.49
"ZzLegendary","g-_OGHvppNE3V7pmqH756euGz5rg2jWPky34FQud7k5aPNg",423,199,173,372,53.49
"OneEyedWolf","f0BRhCgTj0rz-5Hy9prSEXPY0yCCB1k2bjtY4yBmsOtyeKg",1,184,160,344,53.49
"R0ZIN","42HEulxOJYacD-3Z5rkHEjPj8I2SoQy_5k88NiUiP6S9lFA",102,284,247,531,53.48
"Nipote","wKIxj26LP6QN9woL9tl5pM98r82cxlX_dJ-XZoA379Oqiv_u",28,123,107,230,53.48
"KànNiHeWoPinLe","JxhWXkyUevLhVetIk5y7KGJTWo5b7uRuLNppS4LI4_ZU8PlZ",235,146,127,273,53.48
"faithk","HCuKIQxayK6ehUNHRL4KWrhoIPcux5XYyWxiEdUc8st6UTM",60,200,174,374,53.48
"I hate males","FoGJX1YhtDTAxxFcXGYM3Kxn1a9fu7MPV2Gz8Zg-Aahuhlw",141,108,94,202,53.47
"Stef Top","JDLnBiHAjFh1O5XaYt3IgxP4qKRSzV1u2hcV2dYjIbmwsrY",57,77,67,144,53.47
"Solienn","h5EsgF-cra_5ndxzt-GiiDQ1yqzXp3jIgBrqtqP1ZmVWiv4",218,270,235,505,53.47
"Stin God","PjBIVL1Iqyp4W3DeFFoIkto6YcE6Co1vgIQnCbZLZWhmRNM",57,139,121,260,53.46
"SUPERWARMACHINE","Cf3xgQq8YUEM6iiQUUAjDz6ZS2a_hQGCcRwnlG3PZDt-RA12",0,193,168,361,53.46
"Idk Nan Molla","XokI4mrNhjXRGXOpVgP_GWdMbVH0ct4IBOrXO34Z06WjRv0",71,309,269,578,53.46
"One Autumn Leaf8","JXIdqJzSqy8mWBS6eKf6oCGtV_YGQnX_ET3j8yuCn6N2UrM",193,85,74,159,53.46
"Etiroythegoat","SX-6qlC8nZYD0MSALIYacaagDLJ_yj-6_2HjJ97l6IZ00Bd8",164,201,175,376,53.46
"Hong Bao Na Lái","OmkCryEFJlIPlNAbt4_BIayH_F5oqPcioH7QJ-WwhigZiukA",72,85,74,159,53.46
"DrDolelicious","ANpwKpF0ziahRJ0TyEF3rpXJnkKk5VUir5ErXn-xPKDDGnU",325,139,121,260,53.46
"haïssable","Zr-p6KQNym8h86aAn3JSh85NyH3ZexaQqXTiRxfVbSVXYQ4",420,155,135,290,53.45
"PatronusCharmC","oMHl4VTm8M4lvUP9KwneaZgYS661SufjEmKwTg-PXiD6NV8u",312,62,54,116,53.45
"Monchek","Pc2om4XPzh6JDRGDY-tRQvAhT14sa6D5WHjsVuzSd-Fyq1o",107,178,155,333,53.45
"Sonned","GPcAHIS36uQ1WaEVUp8T5UNRqrvmctJcO45fbpu9zpAKwarI",109,62,54,116,53.45
"Peepeeopi","MhXn_1dBzHrjJb75vBO96mnnJM-VmrW625rwtrmkrTfrR0c",308,311,271,582,53.44
"Astocaza Deza","ADNmFSGO64LXIFOPQzMF5t1d6x3nPrM9-lIXk7wDNEFTNJM",48,70,61,131,53.44
"Le Punisher","1QYNuJkgJyl-3S1zikyAUvGUo1peCKEgLQWjV2BA7v_8eYI",0,163,142,305,53.44
"CactusPlease","jNiTFN6DEgU5MjAueoTVWbO3CS_qSmbRtQBCCHWcJjY_9S26i8sdSoEKPw",13,538,469,1007,53.43
"Free Ornnlyfans","5tB6lAqweUOsCExoGHeBBAE3xvjwOSO_kMCxCTW8JCHw-Dn0",0,172,150,322,53.42
"duvettt","wH_Q7HVAxbJLRU6Z33b6qTILbJIY8eeYzMJ50XU2xM8zzxm6uVStfuYMjA",5,125,109,234,53.42
"Edgay zhao","MPjvUH_b4wCNC35A2Z8_9puCQcruddBDt0vTyOprlfCPhMA0",77,117,102,219,53.42
"2021 0118","DgxwPeBaA5rzl1Wrs119Y1u4-V4-z-JKKgF8o5Dnyn5IUvs",90,78,68,146,53.42
"shiacazing","EU1DG70G6ok0Dumg_uE_O4ncIKscQLRQuJqHkSwY1tUrSpo",128,234,204,438,53.42
"SteelCityWarrior","tZNLkhegsOXlRjdGh12LA0nINQO7yPKhZrTYLrmjZgZc7Cg",422,219,191,410,53.41
"Ahys","ilpw_SGpvJ-njaHERlxkiTPak9Sw3FYi2OIei9M9IbZZyq8w",0,188,164,352,53.41
"Shiftyr","S2nycQ3HcNhQgIkPSGud5UQYnPu0y7YJ8vXBDG3OnyI9i1Y",1,94,82,176,53.41
"enarwis","DTO-EkKJ6D3cLAtbhr1NNXRLxQhf-hiEkk_a-pMUj5bx28U",1,47,41,88,53.41
"Jakoshade","vVgiYEmDInk0BM2mwof3vxj6cCjcoM6OnvYDKy3z8lWxLuE",424,157,137,294,53.40
"Buckett List","dfJjtpiQxWMKBp55E9_K9tvicWAI4kQ2spjlgktPlrLz4b_n",44,157,137,294,53.40
"chimneychimney","psTTiEkNABYwAW4YjHfXRMxzWhpQsNKd7GzxUZciykBVqXE",0,197,172,369,53.39
"guochannvyou","qHfrU-vO00BOei_GvVtTqb5Myvh78mYq82aCmjSkvETUtiQ",65,394,344,738,53.39
"Capibara gamer ","JrnS5r387W2cJ_eBGv9V2rVCu42ab-Tm3eGw6hr6V2zoIcI",86,229,200,429,53.38
"KazumaTanaka","bhnggkNzj8eShzVCdwJMBEDsJhrVIy0VAMHGFlgVqVLuC5U",278,190,166,356,53.37
"Excelsis","UcERMXkM8R-Wh2fDBXWxPYcVpY4lCJQxExA6UPra4a76MkQ",17,174,152,326,53.37
"coinflipper420","SSTl1jE69P1sKi-BTpfz2VxrevzhhTt-aInvp-zdSBOXY6M",1,119,104,223,53.36
"memories of u","l_KhrVLqzF6wrm2g8gE4ZcobCwcxqmZOaK5uBpVAsrnWsq8whhFH6oL70Q",1,270,236,506,53.36
"WXW857","CtDBUeUfGfZXlr4Y385w7FSBuxCsaOnCaJZynDjnDDc1po3ceNwQRkAiew",72,159,139,298,53.36
"Rime","c1A_C-NlVtuapKIoDpiUe9JzDf90qKvgNZVzch6zIsHTcLGxdcg91L49aw",339,191,167,358,53.35
"miIet","S7BeeLv53ls281KkAujBB6EQFndcWqBelovRW83VDdRXcAHxGK9RGVLS8A",223,231,202,433,53.35
"ˆ dlwlrma ˆ","y9xEdApLSqZUdyy0JBpZrNs29sizLVg2MP5p3dGdrZfSf3o",17,96,84,180,53.33
"I am in grief","szHLCp7MKbogKG3UNkqdPHxEKwPbNqsFomZf3dZdikwn7VbLdQsZYw-aXg",367,128,112,240,53.33
"Darkong","zexIJUg1WlX-5YR0Z88Y7eC1V5bYrkWttaZlxBfX6sFaHioU",64,480,420,900,53.33
"nt guys","ZQAjBRrUeDMe47N51TGJ_0v-Oyz-URL4B6PrZWKt6ZTPBFQ",69,160,140,300,53.33
"Young Tactician","6jFUvYtR0BvXCfK57vPzM7h0rY_W041WIX_Ha8ngBpgUsbw",350,160,140,300,53.33
"Shisen99","nUFMA3PtfPcGEm3UG06mAlrHmk2qE2HmtKd0pi3nNiQJ7CPbkv9TUWEs6w",228,160,140,300,53.33
"King Brew","y0ZPn5ezrr6wrOwgnqF8hX7pz_5NL-9bRse4Kgk-AikggD4",28,160,140,300,53.33
"HIde on rivers","kSm1Hbfxe44RhhhfhSGWe_PoYtbfkIjnGBKZEw5Ruz53orU",351,313,274,587,53.32
"kennyd15","asCsl6DOx8BmO5DbRti3BHkDXbqzwrMIIXayXGTuMCmVZVo",116,153,134,287,53.31
"u no let me hit","0x0Gb3PUYm-n5z4HKAETa8vgW81Fy3CqvfXVk8vQnms0M04",103,370,324,694,53.31
"dracula is lame","etrmoJEe8M4qCQTsgBFUnANWIkUIJ_oT4KT8PMa1HR4AYaX3IxVZL6OfOQ",306,234,205,439,53.30
"Ruemm","geNT-EWSpgql-iX14ij1ka9FirCuKPpP57dQDTr2ZubG69Q",141,250,219,469,53.30
"SocialCredit2Low","OEv2fHMtmtRpraWy3Va5tp9vuqRtnIeOwoi6fkicVpwS7HM",250,500,438,938,53.30
"Cute Asian BF","_k9DVsvbK8lUOeYKcW7m-afr2obeOyOaVUnRrhfZZnO5fBE",1,121,106,227,53.30
"propaneTank","6V1OPr4M_MYJw0R0WKcX438fs1BJ092UvTrisNWrYStlD2iueuInqsM09A",374,97,85,182,53.30
"Lasagna Enjoyer","kgIaewhfq24ah9mWocRirTBVYCP4J8Y523K9RzL8ZKW5YutGdlUAZUP4kA",353,170,149,319,53.29
"Buckland","Orotp7yHgyPr-nTI3ZLFPs-rHJH8pJlS8HufwMEjhWTFAzM",38,275,241,516,53.29
"Khuang Duan","SWSCjSzYasYgjjBGD7HAwO6pAV70mv0wvSMfbCV9yTFP8nHg",152,502,440,942,53.29
"Abvaras","fbRLc8bNm-odw6HRnyJO6iCFnPPKxlJbcwikSfjkClZYblo",134,154,135,289,53.29
"Harbinger12","4EO_0y2Tj1mw-I7o-MxDYopjscIljtFm7Bu-Zzn6bwu4q1A",80,81,71,152,53.29
"Zeri OP","LbdMtwP1xF9kepyxbhQ6VkiAeGW3QAvevL3zeFk5NRVnC6E",79,543,476,1019,53.29
"Mei Tou Nao QAQ","oMLJD__DoJA-iaTsbhWNKPivi4r81ecwMDFhF7M_nIo2XcM",1,146,128,274,53.28
"raymondye123","bREDhMYaB-0EwdeZ4xVuFJZr67LUR1XNuCiiRwPSyF54c4c",173,252,221,473,53.28
"Iamiuru2","_TwgVjXIpvRuSxnSzuLpnXhlYODdgMUCnmKyGpKXBrX12fY",359,219,192,411,53.28
"TEDDY VIPER GUMA","ysA82ZbLAfORTe-AvIJy-atEQPEbrIgYl3V3oR21WFVjSili",293,130,114,244,53.28
"ITz Big Beedo","5oT0EHqP7aatBl4SEGxh9OhBBQqgjsVLwNdtxzbBMfBNq8PPpgrksd3UAQ",24,438,384,822,53.28
"OmiBro","BKjCIQVsgg95tseBRzwxJgvlWGRmPf7sut_DC4UN8aIHBko",257,219,192,411,53.28
"genuinity","h1eoSpvl3S8n8bh8VgkzzNopo3M5J2IUYk5HcsqBaqZ8TKc",83,367,322,689,53.27
"VariableComplexe","VjeVgBUDNh5p15vvgJZT0PPFmOWC6F2L1hKRNIhPunIz5QNj",303,106,93,199,53.27
"Top Lane Chad","uC7kc_upT2AbBhYu71EV1ANHlc_btDGtrASKH6b_UOSLIMo",51,301,264,565,53.27
"Rodak","REViRrTsfirjBNswpf8IM32dtHcovcvM92c-ORe3uucRr3O3CsSKpGdQKQ",0,277,243,520,53.27
"Flay Mígnon","PgZLYs07XBWRLVtuTM53BDgB8YMDZJhzEW8goo7-PwKL0x8",174,106,93,199,53.27
"zpy bro","b_J3HDDVwQqh4limBPqaoNhJGPsqDRya4q5B2bGI6nQLsnI",1,163,143,306,53.27
"Lol Toku","Gjaok7zkPJjOiHHrPbEnFchzyf3IsaUH5j5qDyXI1NS1irs5",356,147,129,276,53.26
"Ao ye shang shen","5uJhECZAz3AWBkXUm5i0Howk-SyHgV2uVyOUN3QrO5ARLJk",1,155,136,291,53.26
"RoyBokChoy","uFe1PErpLH6noXctMCXfm0AHM6hrYSQZ-RKbBQ_fjh7g0sU",420,139,122,261,53.26
"AarBehr","7e1OhEPYZxe28ZbbIwXSOv21WIPYngu0VWX2heECrh4D9o0",16,90,79,169,53.25
"chorps","ltXfz7HWcl_IblvCNdeX-MoAVNwgRGywv9Oy-galAGZzyWA",33,378,332,710,53.24
"Overheat Rumble","KUoqsafMn61xIqMUVV7KJYM2G62pwyRerWgnYe224l_nNJA",269,148,130,278,53.24
"Kvøthę","C-sLD3b965MeP0GFAXnXzSD0M9zDWSqcjnSa2ChA9Z05TLw",104,222,195,417,53.24
"I LIKE PINK","vcjD0t7o0F6HciWOW3h24O6HHySTkFmXuDMZOxQRdbOsXDE",240,353,310,663,53.24
"Trisend3","BHK9eW7XbYuxSe0O1uXGE9GiefgoBdi53kNrHFQM7Az-VzVzRJgadRUpCg",165,312,274,586,53.24
"just Sony","sV35_Z4HwDJ-CDrYdQlVrsY5b0BzvRqpYdidR-vQ5c5IBHz1I9OzfScbiw",95,132,116,248,53.23
"Le Jk","YeCV4z3L_KU2ZRW2xmsNzrAt4qM7vCA31yGEMBJLw0zQCwDVSy9hayY2hw",18,280,246,526,53.23
"Miella","E-jT2Q3ESMpJwW1YdSBINhmse2nlML2z0TAwH5z_tD-SSOw",247,281,247,528,53.22
"Celesse","_q_zdt447vofyoxsGphD7gGwU2WrBoSv5hAEL3j3ip4ex-A",106,488,429,917,53.22
"gravitybending","SiYIfe7wei8GdfqBQ78hiD0wUy9VvYJCcBnHbnOEaHa3CvAi",187,530,466,996,53.21
"wan le","rTpj7pPXBPUFE7uS_9uahXEzo7Plm23K4xUPQ8WP0jUVvFg",314,265,233,498,53.21
"MoreAxeLessTax","ldLrBmtHNreDccTSHcYM51KznN1nCibeDkY2IAwlmGn4FUqO",146,283,249,532,53.20
"Fresh Iemon","TR9n2mg4e7WaANanAoMWdzbDpxzm_mpIqa1bK7VHpyHGiIiR",207,274,241,515,53.20
"Master Yi Jungle","e81MqGbigsSFPHU0cnLH2VG31yxYRzVPKbBtCpagQMuLgjU",84,200,176,376,53.19
"BoomerDaWalrus","TNt-of1VMh7NVlUnq0IM_GeNyqxkNH8dcxsLTqD0Krz0oiw",135,125,110,235,53.19
"rank 1 account","hs-vt5FA-FPyBMBMeEsAWntMRjUAc8YkTeCpFXKtJU-Fsx1-htGfoRUiGQ",72,50,44,94,53.19
"Gojo","zRJUmc6XNKAwqIuoB3F35UkNjy1A4RFATOdolAYMka1bKys",56,75,66,141,53.19
"Krusty Crab","fPUw0ZJJ8uYmZZxBn7mOTwbg8ev11kCREDm-tRocCnw1U8c",0,225,198,423,53.19
"Me Minister","1hw9luGne_pOn7d4aOxMAediT_SeouYO9qnZOU62cTYgcd0",0,100,88,188,53.19
"iqpor","fnybQJlPquuCdYjPJe7wSpuSotY2Rz7kgI0UFPjRJnia5Ec",17,300,264,564,53.19
"BigOat","Ucx3TfTJsR4NCNuJISkwHxrd1HOzHVqqrzNfFxlvML3VcDs",98,209,184,393,53.18
"allUGHver","aBPSpxS88DWZ8XmpiurYBtPvWF59xENHacFHy-PYID2DGqk",70,284,250,534,53.18
"lolenseu","UeMlB3TDUqcg0o9v6sAzolFhIG20SdEJiXXTXpaG-oy9CY71SV3IjFARMg",43,226,199,425,53.18
"8aceMak1r7","JcKyRbG6RrCKKIxS7a2--8ajEXdeJob0C4myGuV59rmu_6F35c79ACNC6A",1,668,588,1256,53.18
"Louie G","L8F7O3xXxnO8It6J2aDJRaWrpE5kzkT8s0--8hURWYZt_vQ",423,159,140,299,53.18
"Soul Stacking","sy0cUYxgrh48CWFJBOFXnH6RTBXkRXboHji-ZPbZCQ9P9PfIHc0tgq3KYA",150,176,155,331,53.17
"Vasticious","d0YSagbFTFN2vE7eTmzrcU1KPunAn3UNamTe38y1stGP_eA",148,218,192,410,53.17
"Haruka Inokuma","90lCY217aYDIZY8W7_cfcQ2yoxgVl4rIChvRkhS-Kxs7aXYxK6QUxBN53w",448,109,96,205,53.17
"Boy Wonder","9NW4xUZ9w6wTKdDHpgdqQNPVagjeV0HqS3PlQv-8eFZTJVg",1,168,148,316,53.16
"user 4295","UbH7JILmHdibf092TOA97HpD54nm6MY_RQOUBMge8hOAvfLf",88,126,111,237,53.16
"Godspeeds","wUiPZFKLI4k5LpznfmZbc1x_ulM-1rSBfdeHMBu1wxsN4z2f",100,244,215,459,53.16
"Vøndo","5G7Y_gHl9Ur0sxfuP6xokv8MwkWOilnFfdK2esmm9bcuvwA",186,378,333,711,53.16
"Nyne","_8YULBz13S09cZ94ycbupjcVHU4K8n9GygT4gVfFm9K7Sqw",0,42,37,79,53.16
"Swooshe","MF3p0po7raBuTZiee7EXg9mckpA4O_gHu1adQH8PS1MK_2I",457,168,148,316,53.16
"Heavenly Goddess","j-dYnxgUjgEB_SlIPfTjoQdyOvycs698X3SWT3LEltRIyK4",132,101,89,190,53.16
"Flux IsoLatioN","2HfEPFsY_ZIr2K2kqYByZv0JnCUyYl6tAMJLLSHvXRAKx4Wy",233,471,415,886,53.16
"agreege","MynhcrJ7vAwefxtJrs4LoaBLtI5HOsaU6k4R0AhpIBPpjJI",41,194,171,365,53.15
"Takanuvah","s9l4na9lv0empGwAc4e8kpq7NPG6qbecIggflC2edCNePxU",298,380,335,715,53.15
"Skarupi","GnwdlQpQuMAIIqZZ1P3h828FL7tXvqbM35RnZNhOqTHoqEE",341,177,156,333,53.15
"Bungee Gum","z9fhjt1w0K-oUDrzYHHEQZsoDYKlumierV3txF0PY94M0UA",319,194,171,365,53.15
"Mookakaka","G2gY7KjULiUjRNA4zkjVL6Zls0c4pLZYJXIXC2VTigA_cgI",76,152,134,286,53.15
"Glommer","9PCPZj4lu0kGNU4nxb1EdIfAJzsRilwtU97wszh8GhUTovw",121,228,201,429,53.15
"Strike Commander","8ByHbBMOA-fny48JS37qbDvDBuFfBNUw0KjQjrPuLaOXB031",0,245,216,461,53.15
"Jànnå","zLL8W9iRTgTuDWFyCU46U3z1sPTIOdbVTSphoVewQvSf7jY",339,338,298,636,53.14
"Azure Time","1YwMTHof85t9SaS53OVYSoMBUv8r7RwEpjKT-eWm4H33mQU",411,169,149,318,53.14
"Crazi3s","lVT20l6UdB01hSxggu9wwTpy6oYfwJygaB-2OpqPCzJj1Lw",34,263,232,495,53.13
"Dreamyidle","8DVDCtiFdMprErJRmXGOnn6SDT4CBpJWns-aE0F5hYLQa74",71,204,180,384,53.13
"Ronaldonut","Ob12C-G5gs1xObEVLAP9u0Wf8iYaaqCW_H2AzwgTjSKg7mo",150,442,390,832,53.13
"Zenora","FPzCXeWfwVo3hHGvZdP6UPEV4RWKfx-1U8n5TvD1BDsKd-c",0,281,248,529,53.12
"babydaddyy","Z9E21tMR3BQN5oXfYzFERmuNClrsNvzMtennlkFSyy1tVL4",118,145,128,273,53.11
"ggbenq1","WCJXdNpnSKutJnnqjl2WxVrRV9MdHkn0Hgnz8uK9mbS1QUc2",122,94,83,177,53.11
"Pooooooooooy","YpVq2xarMtky8RA0ZMJtyXnemdD5Nl3q020rnaBdWBP-cxI",62,461,407,868,53.11
"ALPACA ADC","HhoDgn265t0IQkZldbsMoP3vkyoF9Dx3OPpqDzAVPNPYJs4",69,283,250,533,53.10
"LotteryApple","4zFQiBEq5ep6IZIRz67lcXkEfen5g4tqAfWKgfMXetNSb5E",0,137,121,258,53.10
"Coat","h-aJWANU5dzmbU88QXa6uJkeicgYIxVndv5dikSE6E7iaL4",1,300,265,565,53.10
"iluminnatti","HLCFlcQsN6VzykM7mY2Rj5jQwwzme2cZALnQHxgyneT62aYX",254,163,144,307,53.09
"T1 Fraudyusi","Z1nXWfEONQ8eqvMbJYpj4hfR1gb8d_sWZ8-wi8UrShmkdBE",1,163,144,307,53.09
"Sakùzyo","F-EqTp8OweJBemw5zvLN3JFyAjnyhY8pVMTBrIIW1otLihA",16,181,160,341,53.08
"Heartbroken","zxnVrKjuwrLLl9FLrn2ifayuQMnfqFaI4ZbC5lU_7875508",34,155,137,292,53.08
"DOSE SUCKS","mw_pUrrXcs9eJiryVL-9vvq3iy0Rdum2SvP6NJLNq-uXU7I",0,207,183,390,53.08
"atrocks main","uyZquFviRnsf_mG6pOgB8OmOzKBa9-T_hKybb7e1-fp_1lM",179,112,99,211,53.08
"WX siriLvemin9","8ESa-W__Kv1JpujJAu9iezjyMaVD3jLtml-w2R0WVIJhkyIm",384,138,122,260,53.08
"TwitchTV Sekune","jWKUx4Bed5kmr-SKoS4LSunqzMFqzRW5w51CyRPBoPAt8Atl",57,268,237,505,53.07
"Soulsie","GAz5GOe3drNgpL0lLIoiO8CK1DMEGGJK0W-XgqQzkhrnNssTsu3we1eZfA",60,268,237,505,53.07
"Jeanine","ThJI811DVWEOhnvlEdzBOooS2gT5oY0OxrROQFBO6u3RXPQ",179,121,107,228,53.07
"Nachy","Anfs9xbNsqtWNwPARCG2iSrzeTFhhI2imSjE4KQ_StKmSnM",0,692,612,1304,53.07
"I     Jak     I","z06ZOg7EOOP_Z0wSUeqeYs0Kk6N_QrxI1TlU-w7McYMv09g",23,217,192,409,53.06
"Loveless of Me","MLK8qVNJpPULX9oJ5g_MMpq-sEun8x85DJ_ETpEGUXUAGFlT",1,130,115,245,53.06
"Janies Kitten","0XS3-47E3rreAIuHUTdRmhz4s3kjne3tE_TWsQx3E_HomTf-YzBe8hjRHw",345,182,161,343,53.06
"Belko Experiment","L7oS71Wfx3On6bxXAPnydaKsMp0tPr8BOrn-X2X9SlmckRj0D6Dit5USDg",1,226,200,426,53.05
"SW7","CtmnwgmTcSS0OyWwEaevzBD9ssbGLbMbx3qhN53ziWgWT_RP",266,139,123,262,53.05
"fusq","1cHX9Wmp64ZDfpBQjHG_FPNsH795nvCCw5TY6TAHKPfBv5Q",1,252,223,475,53.05
"Legacy","8QL3qnaYorhsvetfRemuUuvQK2IzB9deBQhSfjO4jp2JRA4",303,139,123,262,53.05
"The Sunrise","PVyK5dtPYQsvWPSe9XeSLq5GlYgcVfVwcuhabb4pqtVnkMQ",162,139,123,262,53.05
"Mommy Give Milky","H0T4jy9KM4RfQ-QBTOyvYEFV00GwRkxA5LlwOwHy1xa98pk",15,139,123,262,53.05
"Daman Lyman","79z1RUFa-ssWh7-ynJ4m_VrbJJ7flNLLjiHtaFOyoXJ3Lqk",66,165,146,311,53.05
"Getbáck","5TLfbdrshAKlpWni70adwKUfABvsrqw-QqpZ3X8S-sj2hO0",258,278,246,524,53.05
"IMAFREAKBUILTDIF","u3UhLzx_0lwYWfOqHQ8ichkmiz8ZA-a12R0dEVUrrzwr9s738uCq_6uvzw",446,443,392,835,53.05
"you are so cuté","2Br1IkCRPDzMsHAiQ3-Uqc_G6u9cmtE3eQNVngqc-H9kl6c",352,331,293,624,53.04
"Dizzu","nCLPX8z6i8Oal_31Tmq-BxPdSblB5Nj-IJW0pJvm3Ln_uDk",55,61,54,115,53.04
"swallow orange","34WUN1BVQvCQYXkW4vWZwCFooYodcOy1TI-3DlSqXvHuzkfA",17,131,116,247,53.04
"Ojos Noche","V8lFCVhj7gpJ9DAbCfprlMzz2OVTz0tZqDv7hVQRCADu-Bht_mBP5TmRkw",403,262,232,494,53.04
"elcëy","7lW9FxaLxJRK_K4etuCeNf6m8KogxOJJIut9fU88dQpJmNc",158,368,326,694,53.03
"Rengar N Bush","PgPe0bOfbdzv5Ek8MoWJAKcSJ4QlqF4fxfONYCxT-LpMr3P0gafNUrTwag",394,472,418,890,53.03
"GrosGrag","gloICD7p1f3lgNK8p0VcHq1PantKF1iIqyeprld7C-0w45g",367,184,163,347,53.03
"HappySmileLove","mzt-JtSNUfaro_cnDpJXXgtPVnjwwU5pwDFEN_A0ofya04hJ0WzxWem6Zg",227,114,101,215,53.02
"BU Midnight","cw6XIfqqoqzzYSumjwjSnuWFXWc95QlcDvW_bkkHkNXdGgA",0,202,179,381,53.02
"EJEJEJEJEJEJEJ","zniGXLS9WHONGeqw_8h2JAXfowtIlvRiGn5Hxr9HcTAblyo",162,316,280,596,53.02
"i will invade","HJt_lw792nf2augqOYdAemoZwpchm12CUjOnaZ15MQANyElt",1,185,164,349,53.01
"Lovish","FH_jCnNGhJAMG8bTaALLAJdjDCxmhYWYIm-WwqTZlPi7G3w",68,308,273,581,53.01
"Mute Chats","QLwhluB2altZ9mibVXnxAnqk9u4jXepSgfMLR2Us0IowdO-5ok2nbsHQ6g",84,423,375,798,53.01
"heyIog","TfYWtSmm5l8YHNeHQjp0EGKOkpE-9RPxaOKuhLlI_9hjxw8",388,255,226,481,53.01
"November 7th","7Y2hoxIcdjwYBZQGgliypsyWugYYwebHB28Mvy32B8i_HdC1wgV81Bg9EQ",89,229,203,432,53.01
"ooOrangeOoo","sNmwfziRUwrykRw-tap8C5uD20bMseMq6Yj-TXAmIs1SdsuD",79,106,94,200,53.00
"Tomozaki Fumiya","8IQ7XMkXdvxo-a_ld5QukMXnGNnLKHrUfL0F5UW8qlVCsko",87,221,196,417,53.00
"Moozi2","K1k02m_eMiXNd3DuSVDm6nrP5ur62mDpm0oLyOHcYq2feLjWnxe99qEdHg",372,248,220,468,52.99
"Hexader","G6NOZYVvJcQepFJxfiD3jI5xmf9XyQxyM0-RcdowSX8gGHI",309,425,377,802,52.99
"Połaris","fLyVigS6A1COX6tVUapv4qF9xIbqxpNFQ6a9PKIlonwrC7k",11,284,252,536,52.99
"Nińe","GiPRJskNZg-qRcrCsgXFpjQK59vZnVrf0hvpUOX-ZF_Op8yu",119,275,244,519,52.99
"CE Verticality","kx0GBRgHsQzbgCpeik_Kx64CGP-ixWlqKs7Y7iQJUL7ZxDj_",108,408,362,770,52.99
"Do it BIG TFC","DmdTVlj9F148GNRiCxBIro16MGU3aWTBiVI-WXl_juOjbcY",0,275,244,519,52.99
"maomi z","eN5Ad1HGOn-lI_q4x4_JPep5NeQWDsmqVH4HfI8D4hLwmaBE8ut3-dUpcw",1,250,222,472,52.97
"BiankHatsuren","h5MxCbNOD2ZeS7eQPDqgT3l_EuoDuvNRM3G8gzkWSKz-GgeibA_CU28qjQ",258,232,206,438,52.97
"deadLi Q","0sI3J2TpNRt0MN6GK7kUVXb5VtzPczMcBPCwwf3XM_ACsHU",462,196,174,370,52.97
"wavysixteen","WUlXIVQ-K0rtyMhKsh8HTwOB5-cBpg4m2B-p6NNP-_zBwTpv",83,357,317,674,52.97
"swiftpaw95","EfBJ9YafTDQFazFg1nCOEiU042QrZx-ZMfH58cRgaGx8mns",222,303,269,572,52.97
"Love Over Bias","-7b1_NTJADBitwuhnYuitLAdVTvFjWi7FryzjQGajglmhjc",16,143,127,270,52.96
"Kuhz","G7X8QnqbYjp9MowmI1kq2Lb1kbFiu_QqGCYVsnS5kzF8DVA",1,152,135,287,52.96
"Chunchunmaru25","Iteafgt3P84cckMw62Rat2uFXz_TzViL82Y-b7rfF0gNa8I",110,188,167,355,52.96
"Neenx","dOreHFflnucDoPp2RmqWTx1CKy2tnWof0smo9Kx0-eL1TxA",176,197,175,372,52.96
"daelily","ayvpI2wl70OWtz3NpbuAcUCjmS4EW_eq9k472_sAc_wmZot3",62,143,127,270,52.96
"MlLAH","jDRA20A_s2ZZq5pEOdNj3Sds2_0LBqAXQiUIYxPmviH5aX9BUfyODuwH_A",166,286,254,540,52.96
"Kltagawa Marin","Mg6UWNlIkGEUvbvyGLv_-WcICVvpbEP9HjDhKPjK7NEuaec",1,161,143,304,52.96
"Souta Hori","A9hYrPirf6C6Nq4Esz8hognYznznWI884Sl5gFM6c4t_9hWp",86,278,247,525,52.95
"Juhrome","s2bxMbU0bK1FNzusmvEVbavtxva0_xkAlmsLNUwvIqJ8omo",0,493,438,931,52.95
"westífer","bbjQppQ8woM0ydrZFn2NjGe8cUzO1p_0eEHBu5sUHCVtGhk",187,422,375,797,52.95
"Baeck","eSSB3mFt_G9ulQiQYJphETIiFzKSfOj4BDkCFSNcfWlqEDY",443,333,296,629,52.94
"9s2meetu","iNDXEjbkhmDS9n-xcheyPJ8YsNCRo0gnu_pjb0RUtgPrRPU",20,216,192,408,52.94
"AC ArKon ","CxNkgAVC9DpwZhKCCH2VWu6pW09tVhBgVpyJYblQulPgMEk",202,243,216,459,52.94
"TrashChampool","pYacnCWqAoHygavkFZqSLKDEPJNLLa8wgz5cB5YFMi-ZtY5G",249,126,112,238,52.94
"UgotWreck3d","XhUjKj8IbqdUisasu_wtcRA82D4oydPzLxYmW1l2h65C3Gs",166,144,128,272,52.94
"ZELAM","lJGg-3Zd_y67WVOK4wWiHLtp3HppaK7M2YzpqGGO65Se5bM",282,54,48,102,52.94
"WoChaoShuaiDer","ZMKIiz0Nz82skHn_JLBfF8FAZGQZx32AKyJal2ZPt_oTTu4",240,207,184,391,52.94
"Bandzz","z91Sev1kNoP5OTFUkafNc5Q1McEhYoxQQBhdmyxfmMJzkgc",133,289,257,546,52.93
"ffja","Y7OKhOR4lSW8UfxyZr0M2JRNM1w0vGLsisCANjAE0JQUF3g",135,280,249,529,52.93
"jecyhs","O6SPLn1U7Ss8S6cd9cV6dKMZ0GUaLuuNm_fDo42knt_C2PFB",65,208,185,393,52.93
"Doubtfull","XNluduAgrVwkvjgXnIYtL8bM3gVgVqhfGPQLm66mBk9JvzU",158,163,145,308,52.92
"Wic","YTTP7D84UHmsyWb4EhT8eMaBimwPakfgQtgm-elZAmMwmgU",0,190,169,359,52.92
"akn","ScmEaOy3hMsp9wp46gpik1MmSIAFSTnlboMbTHUcn0U40NA",248,355,316,671,52.91
"Missiletainn","XY46CYeDwbcaF0Kqzho4Nqvu-g-n0RDfzRPxwYJtY30Vx2M",376,318,283,601,52.91
"xFSN Saber","TiCKB_ncNOC1bWSiUzxfu4-_GM6W1A4h06fXrwMUhq21",1,264,235,499,52.91
"CarrotQAQ","s1ITsyJmiL3Z1JVsKGXO4KCO2IJkKbOexZWrJiakp08_M4U",134,274,244,518,52.90
"Vigorous2","9BeNLI_J8_nkeYv4ocEoufjRfCrnNPbp_MOtNPFcgSrbAIta",391,529,471,1000,52.90
"Aeriya","S6Clv8Lm59YRgWQvdHafSMkxmHs1hPo8-PITmW_5fob4K7U",106,146,130,276,52.90
"Frìsbee","GK4y8Lldo6dTYAY34eqcChqD8cFeYjO38blTMsyUjFWtY7E",56,310,276,586,52.90
"0CD","kgkwpRS0NhnaqLfPDnMiI3DbFxKt4EupJ03YExizRFJ_MBo9fnScDQ-a_Q",106,237,211,448,52.90
"IIlIIlIlIIIIl","vfG1-lL0muWJ-gZZwJBi3hMd_gqGwqDWqlfwqwLAg6h9SRmqA9C3FUrwhg",18,82,73,155,52.90
"Feint Wake","XF-xTZZmQIDkxWxEreDiyXRIGH8jXWfqRD9Vk7pz11RSqhM",225,128,114,242,52.89
"Sand Painting","gYcl5azekWUgpUnxD9j05t38E5Wjs5Zm2ZHtHIOXJ5WXKDc",143,256,228,484,52.89
"doyon","pqm3it_qufDNAFLhJD_3CmNdYX7w5R9Bd5U4kw8FI78NCslA",14,594,529,1123,52.89
"JimmyNeutron007","-n20Spx-iDBmFOmFgV4PnxA57M4enMf8Ay9yA-0qnlCrO-Q",29,505,450,955,52.88
"Kairogami","kLHtDzDlSXi9MF-BfBTUZtBYJunzbbpPaLzAT4UIVuvdLeE",128,275,245,520,52.88
"ZED O1","ePJRezDrkurBsRETsxUbG6mM6EH6RTX2kHJaZl_9gJa-PeQ",113,184,164,348,52.87
"xevi","v-OY0CkbzzZGd8WcYgI6fmP3GEdK6bYeKKNY16ni3ONlx_c",0,276,246,522,52.87
"gayligaygay","heu2EQMKuR5SWd1QCGL8AKDS-NmsGTHzN41teUff7Py_rEObS9w2Zw-UDw",153,46,41,87,52.87
"tartarush","EBjtCLdkgHbv0fRO-47bsjN3I-CUApAIn3oJ_17Z3zwh7zs",395,451,402,853,52.87
"NanoSpeck v2","u0g_cccZEXY21bBtLT2klon-nr0iDKOCh8GDrF8n9geAsugcKNb0mnQYKw",22,185,165,350,52.86
"Brookfield","wlffzBj6pP0ew1qsK6fgEyO6e04rhBMnBpsVQBEMRCDl7uA",188,277,247,524,52.86
"jie jiao jie zao","WmQlgNsFJjmj2ID8nuC2KyHxcw1n3W7Cs3GO1aSYTRp7jn0",22,37,33,70,52.86
"Minah","xbNprg_hLiwNRtny_QCDor6DsZDPcm_fDViTcCjC22MOoRs",475,278,248,526,52.85
"zhanquefanchen","sQSGBNmEVZykDdAh8f1bL0jxlXNaZbKKtfnV0i8Cv4K9vgU",354,270,241,511,52.84
"Skreptzor","S0nrNE1HTzTyfGBq5W8hDOJVviiw7cu0QoHRTCMAMSL7hdw",255,177,158,335,52.84
"mohawk","svIK0yD4oaug_qlb5E4hZsKdPX8iq_N-7bzzBac1DVji2v0",405,121,108,229,52.84
"Yasıkof","fDXXxdsiEZeuJMdqQ7V_gXXuBFG_JsCVwROllSUy2qJMJ3W6x2gaP1aBQQ",168,149,133,282,52.84
"FoxBarrage2","0-22wE5ix_sQUAgj9ZVF5oNJoqpUUhJVGGjxzxKHjSShrVlQG4F1jal6CQ",112,428,382,810,52.84
"Crystal33","xvQr0zLznc3D_rU-EyZodhNDf0qx83cAWyluXX9QlqI8u62e",104,223,199,422,52.84
"HAPPYMEAL444","-1v4-86psEg2nZQRk2WRuJzObGxhJ-Q94AsKncvlF51GrMIS",1,158,141,299,52.84
"learnest thou","jVRPag0yrEo530iE6DewKg_dfymna1HKUWJcB_F6IS_aJ6hqvSq-nMyhZw",171,327,292,619,52.83
"RareBoi","lHpO_N71YuLepxGWDw4-Wr_soyNqTcEFofoS81NXUHOfJXA",252,224,200,424,52.83
"Giddy Camper 7","YaA1jvhwoWKmx4Be4ANXb6LFirL6t2cHiF6qEZ7MzaQTlbs",347,215,192,407,52.83
"gyeop","jj-6L9bga_dyDXDYtaHyV1i2Qlw4VuMSC8H9b6SZC0sPZGA",281,280,250,530,52.83
"pwVX NAdai666","BvaGK7k-RkxBIPPInW5j4bB9958MlWLmrCEfp7Jfyq8m2XJzbD0y4baW4A",153,215,192,407,52.83
"Washed up John","sz_-iMwXP-dCbbp4Bvgj8ssZqFelxpQMJD4dlqP5_htXJCM",286,75,67,142,52.82
"RushFrog","YPMGGPWoN8g4rMsjBWuydqMmBYGQsUhJqWtz5mH3qo-RdIA",346,421,376,797,52.82
"PuertoJew","JFAIuE6Sp-21u_eROudpWsJluom6n4q7GoESd2m3JYWd8uo",299,159,142,301,52.82
"Jonnnyy","llpbCP1lHkeaBjnms9YbNeIYpqHiyNVwcjAp4Bu7QLkULLI",22,374,334,708,52.82
"qxc","gQ9kCTux9T4wRFgiPQTGzmeqAA4MuVMeJmHUK1McjFelqeo",0,329,294,623,52.81
"ai love tomoe","ths20TeWuQi5xuNZnG54hL_f6vI7xc9o1R1qKZr-z-QdJz5oFXKnN_dYxw",161,207,185,392,52.81
"jcornonthecob4","lsKd6k4awVhzbeEBbWIn5wvIwJOgHavrBUOZcLFof2JdP4k",120,207,185,392,52.81
"I am Kitsune","qaULNlkvHQG7j3oOHXudOTxGF-aHVFfo_iDMAA8FhiP584s",30,254,227,481,52.81
"Zirv","_HAcYsKqp3jyFcGUJiCSs1D-1fIzBROIrbBzuKplW4kVcgo",98,376,336,712,52.81
"narakwon","ansjFE_LpsxtyHKomgYe-ASaQmnyOuct2NxLTZB7R1H3Mofc-UIAj5zsWA",117,122,109,231,52.81
"Sonå","YKTm8ZkuGflxa6MXp6SVpHIID9b4SjOpPwIuOrm1n54Kxn764kDzlkK8Jg",19,122,109,231,52.81
"4ft6simp","M8I15ndTB6o5JlUgdRZWOSv9Rans0cjuGXvmilYs-HkX5NIolU-3hiBAIQ",79,47,42,89,52.81
"GloryIron Yang","wJjaqNVRMwLxNhdEnNsw_Mzi8K97PI7DHb55Im5TJcgR-Es",152,47,42,89,52.81
"joye","BrxZntB7fKNB59CstISlUUnoJwFQV8yK_OqTH1F4ARWYAXc",140,151,135,286,52.80
"Stay Mad","hUNxwf09eqFlW45mm5i2DqcsOQBfefpOqgDrMtnpk0yzMBcMN-0Z9z8ECw",320,151,135,286,52.80
"usered","qiSbyvTEI5HfR04N_RG9voPZgxC0jit8QMelFLln5BooSmM",40,349,312,661,52.80
"Yuanzé","6WZPePZ5rcZenotdgFTZe3v9WligX5vipw6lckefQ21Flew",0,151,135,286,52.80
"dekkar","AzJ-EzFt9DzuHFWYLhsEOgYp1dXTJsDql6mQaxRf_WRxQ1k",168,151,135,286,52.80
"Deeya","Y2L6z3Uq9jtR-09PvW_3-IguUTU0MtV9CwH0asYLojlLuX8",415,236,211,447,52.80
"Lamonzo","R7RIq5ZRCYfgLqA5nKEGtZmdMhQ0C82XiZCoOuSRbmLGwJs",0,104,93,197,52.79
"Turc","Nd_fOQz-KKdIDn4pkG6AI_Zp9HzRbs2oKtb-kM125-zv4KI",330,161,144,305,52.79
"Sw1ftie","5MMYEFN8sxxSIBhO02LthC-RJ1BppYDFVoZlMdUvTmoXDbvc",0,142,127,269,52.79
"I Am Trainer Red","Q7YGYqdrB7U1wzERXxIdAjlijAuEsRxoPZdIMMpk2e_oqiY",1,208,186,394,52.79
"sup gap ig","WjS_-2vHIU9tT5Dfk6S1zIJPUcEzQ-TY9BisC3j6ZLqoLjNjxej18ejrrw",115,208,186,394,52.79
"team is stupid","X40WeCFEauSLvZ1_AribSLSAzUD2YzSewweyvSXwjgAn6ws",1,294,263,557,52.78
"         hinting","NpqGzYwDf-GdEbQLq1i9gYen8ccBSwE1VAtrPAPYzDgY6lu27r3Z5w-_Xg",1,228,204,432,52.78
"JCM","WuDfOUW2v7aXKc4oNnEvG6dfiBXdeAowqVpaOEB3xTGqCrY",64,342,306,648,52.78
"tempmfmnaoznplku","g3MUctiWMaTMeP9jf11ItyXw4Q4EFrpUN9pF1dv38SKkvDZ6",321,57,51,108,52.78
"MasterDuel in Q","QavB04y_NqeedcuF3syJ5WM-D16R_bTiU7VHTs1bEHR4qXY",202,418,374,792,52.78
"know pain","PAxRyHVIg-8AZv1GtU7JsFoenKUUn3wLxz94IsIPm9vicyA",433,324,290,614,52.77
"relatable guy","jb4NxciZr-5JJL26hMAxXtRZDkaIq8wdtefDa4qlWBz-0DQ",433,143,128,271,52.77
"slow toaster","tIKdO3X39MulKR4Wr0fJPDuGHC1QKFovITRuipNLiytrAJM",28,200,179,379,52.77
"JP Montgomery","xEM-4U0dVSy_CbNWwW41bgSk8tbUBVPEItKcltl-16Xwkqo",128,162,145,307,52.77
"Pushin Ponys","KhUxmXLpHjFpJhx7G4FKrNDtsbVFn_krcnzr9kmt5b13t78",59,571,511,1082,52.77
"Døubtful","824AohH9lSBImIurbNyp7t7uMQ5R6e9Tyj23pL6mY6xXckc",352,162,145,307,52.77
"RottenH20","LiuVHApdNx-Jh5GbBvSIXwBs9Epk8Du0bOqqLlw4Me-aIulD",179,124,111,235,52.77
"Kennedy","49sYAYQyUZ48d5FzySYxS4z10Dw5NOf48kK7xYT_IBonAbc",104,487,436,923,52.76
"TLC Lightrocket","sG4k6vGU6sXu_u7AiSxQa8Njs7OnE-yO0zeywv4fSrE48801",265,172,154,326,52.76
"I Think Im OKAY","aZCs4FnATcJA6hW3uSTLmvffgabLEk036o9Or-oqmhXGCv4",315,105,94,199,52.76
"Coconμt","PfEYQX79H5caAYLK4ZHX9VhTEczc1GKNnKMjODu3wPLmC9k",1,268,240,508,52.76
"ÑItori","7WmMPlg5jdl8E-HGNHepE3RJ4X4fOsPCmaOuVi9U0IxTvQU",1,239,214,453,52.76
"loltooth","KCQ0NpHdjB-5ilN92HJtx79mIyofaSFJ5gQBFiNY5WRmZX8",190,268,240,508,52.76
"NA ADC Player","YqjTw0_QQEplh1KzDdYr7Bg-PoemvLTDZeKqUz6BmNvmyQM",145,230,206,436,52.75
"Gohch","Tqab2_FE1uDYlVCxFSjY3pFzPpybdxLdePN_zhXNlFsV",241,230,206,436,52.75
"Reformed koalav3","UWSLcQdenOS3IuQTkRM6kaUYwP0Lj9vi-8xbG3RjAfkBvzU",57,96,86,182,52.75
"chrisnam","WoEzHZA1wtksGpWaMKpVX9uLm8uN1MiKB3KXxBYvaL6qvEY",192,288,258,546,52.75
"Ai Love You Too","ZOqYvmUUpSLhPvQgZT_ye0UAGvUSdmrNS-wb0fypqS0ZU6g",1,48,43,91,52.75
"secretpotato","5BudS8JaSQ3z0Gd5Khh9Oy-MHFFqLzKVqMARWJLHlAcjRUs",353,182,163,345,52.75
"Lord Of Lemonade","0DdBUjyLqV6KbVykSme_AIs7UiQyNSK80-Dvni3J0NjhUAU",36,326,292,618,52.75
"Samidare","R3at6D7r-G9u5Sqh0tjcde1NfqGhScvI4KE0urnauIhvEVU",120,48,43,91,52.75
"Fachizzle","wZ8Y0VX7QosJgH0QTBXi2Uv_GAW0U9S-pEmnm8E0RLEd53g",311,289,259,548,52.74
"MinGuo","6C1xhkSC_1YE9k2p4nO8-7KXtqch-4XTdRKkAAZljZ7yvkI",224,212,190,402,52.74
"Dragonmini","rx2n0xxNl0ZQGCebqVKMF4ifeFkZutEv5BhHu0XOnUVtwjk",341,106,95,201,52.74
"Airawn","WEKiQVs_Hl4dNZuHXF1VyqQUnp1L3UFf89MmKGsbc0vK0b8",321,231,207,438,52.74
"Iumnsung","dkyVLymYV_uLzi7KSJpjUWnM8n1PoOXWSul0kSHDT7eSrJw",24,337,302,639,52.74
"ritzius","pBF58FFN8KJ2lHVrDcFPCMBFWsyMevKgbjCcTDaP53CtWPY",191,173,155,328,52.74
"MoonSWDG","58ti6rS3hOenMohgTp9SwR0qe-vSs11PoRtWJmUBKKCVH7s",0,319,286,605,52.73
"angel hours","7TUDX7pOO63Tv9HDaweNECaTs0KP2hKONClUt0oqgLwB5kE",102,261,234,495,52.73
"FlubbaSet","8fYtk_ne9oy7hbmbdVrM_8S7a56Z0YiK-hHodqRZkMCAcgUL",132,164,147,311,52.73
"Kaezin","SkfaL1KXoJ7aZHn7A_v9A9vRRqdBe8Va5tDS45MQDDAO4W3x",15,135,121,256,52.73
"Alex55137","qDYcANRT5XfCszaIlDU72fdofntNRshNIRaR3h8t2BpD9uQ",334,145,130,275,52.73
"miserable1","df89GrhY9ps3X5wtaCYxnezkyl1p34Lepy8GU_lLvLM5j3fA",213,309,277,586,52.73
"sponkninja","3bTYfPVu1Dv3gE60DYEMujwLfrChdtTJXWcNSrUJ9EMrMKM",252,203,182,385,52.73
"CommanderLony","yVusvRVsKTsh3c2mVVhkwDHERhqU0L_5_gr8G66nzjQrghc",176,436,391,827,52.72
"Bu Yao Làn Bai","O_WK0kchrY0GzPm1vrIY9mpE0aj7F2MtBXOmsgZj35LCXoFRe7WIFbbnTA",31,97,87,184,52.72
"Hawkster","3HmxH4myyl1Af1qP1x95-2auu9C8M2qE13l835oLx9jDC2g",289,213,191,404,52.72
"StegoStenops","4CTn8NUbKxUUFjrozIKR3DON19Hy0_280YN-R4ysbB92MJ8",33,214,192,406,52.71
"Hecti12","qB2vMpdhzTNazHxHVrXUze0qNMQ1xSPxiL0yBGAhtq4OFvo",103,146,131,277,52.71
"Buelow","CKQ4NIMzCyukmRmYY8Sm6Ox58ONuGVUBCZQ70EhmfcxASxQ",224,107,96,203,52.71
"8 Spins Per Sec","QEQkc0jGh9Pk14HoWwM9NXvXHMOhUcgYPx7WR_YQg4iotco",46,301,270,571,52.71
"AND 1 AIDAN","Ay-uQBDnYW3BtgBON_HPs3rMqDSwqnTmAxdifRDr1VOFj1I",336,195,175,370,52.70
"Lovers Suicide","E9jrqtBMUKPn1aCDeR04wbmt7oQmuXTyajgoYkFcpjI9d-U",0,234,210,444,52.70
"Alpha Katie","bmdr076HdiDs_eSHRZXn128k3sKVvBNLyLkzpY6jljz5j9Y",1,196,176,372,52.69
"Esmond","Dfu9QC2KKPDNXF_q0DXmLah1i551rnH8gJP7u3T9q_QEfWw",1,137,123,260,52.69
"kat atk","GgBHcMoCs8H5O2LbfWmt_F9iHSsBPZy249hGyaZmIqnweak",38,196,176,372,52.69
"AP3 S33 AP3 D0","YCyeqRoeHe8X9DwGPQodMorNFVzq79kGXkUGNjMFamU6pbaa",248,440,395,835,52.69
"Byrd Bellringer","8E9YfTbgo-YvzhlTue7IT6XLSAVpulvp-IPv1tJlwKK9by0",162,225,202,427,52.69
"Boyru","3k4QqxbQSUW3p5PYPWHQ0VqbAynMouynYaswGEjaOkrNKt8",457,176,158,334,52.69
"Lêon","P5u12fPJZN0XccrGli6tjNm_HycqhNyHChQaU02yxXP7sIU",0,186,167,353,52.69
"nightblue3","B2s75muV08da8yjSxFJx_dt2K2AUfAEJzu0RCW9jq3wJmfg",143,373,335,708,52.68
"30 wr jinx","YWBp3gvSvpsCA8gTh2KJdi3gKFwTdzOjM26FINvqLRdU47w",19,157,141,298,52.68
"pizzaman007","2csYAuyegO19L-OiEZYY9o0ZuvFJkX-ItTub59aTkAJOzQY",1,315,283,598,52.68
"Pink Ward Warden","wOy8zQa1t5Cqa35bJ6SUXqHQEK2J3xlMdFWrWuaOak7t4BM",307,226,203,429,52.68
"Tomoebi","Ogy8B8VUM-imy7qiwcJzvpEZCD1nhbOojvR3-cmC2IO7qAc",266,108,97,205,52.68
"BoilTheOil","Jo-tpriskyX_VHbv7yHwf1SwSFLyBlGDPdoIvWtnZb6_GM8",328,118,106,224,52.68
"Summoner V","wHqGuxtS8rrSRrUnKBPohdT449I6SSEsm6OvSJcy2sOhJM8WmzTAoi5zgw",165,345,310,655,52.67
"Gíõ","MCYuUqF8R5IFMXbRrgz18BVRhAWEAChXZT9xWzPuTNWkdFs",18,148,133,281,52.67
"soju abuser","uUigd3U3EK3XQtTJv3Iy1ryTM4563LA8xSX9Z4b33PSqk6E",20,158,142,300,52.67
"Ability Haste ","hHLpf2zrJnXryAVtlwBw2FWH5Y2_W4vuddn7IvX5ogUZaMwb",331,366,329,695,52.66
"neêko","w-g8Z1-oqkmxbOWjxRAILr1MgnGby3k8z1385SazMvz368Q",57,435,391,826,52.66
"Nong fu san quan","G7zg76vIVu3bRzD7PbHYHWvvG-BcghjYXJixg5iHcKVmOmg",71,257,231,488,52.66
"36D Ahri QAQ","Sk3zNT3dXwxzPhKa5WtBJkI0tNWx4LJ5QvG3Cacn_u4WDmc",1,129,116,245,52.65
"Heureux771","BWrxdzcTzpLkaTyzXKkx3rYdlR3Y6xp3Sz2Jw7QNz7DI380",184,497,447,944,52.65
"candyning","uR-fkVhQUqQz0qsBtwUGlF4t100J4MpcCYMdifWcO5gdm_0",20,149,134,283,52.65
"DukoFangirl","AU1sg-w3mCHWOceYww4VWus13tD_KIIgPisIL1FWxaqgmZQ8LNkQFZG1wA",51,248,223,471,52.65
"O      A      Q","RaqBIplrguA0BqmkfyZR9AlIq20z-k3pOTACUYVnH1n0RRM",1,189,170,359,52.65
"Chirag","41X4jTgg-8ARGSGWfDD2fXwG98AENmpdUl2Q4qcy6i-pHOfu",163,199,179,378,52.65
"YøurMøm","i4pKQcQC4f6mycmLQrtCTUAb4oPQ0iLsMKddLs6O9Ncdw385",168,328,295,623,52.65
"Sera Song","e4bjBq2ATTRw3DaqGwWh8FZeQkmf1UF2CN4qPChArXHbmPw",91,399,359,758,52.64
"Kakooli","ZIED29RrdEY34aPdBiEgIbSP2wo2hcqxhGsc13fMjmSEAbA",15,279,251,530,52.64
"Iwandy","FWLWI9Vgj_iVXMEWE4s88WGCW8nSoTTppxWWy2sgYjSnGLs",163,80,72,152,52.63
"Inferno1","gw4Ny3ZFmDaBxtHH4mudBRS1fS-fHrCO0dByffXAC4Srl5k",124,70,63,133,52.63
"nopointanymore","dRIWko2hsV3UnAnvkGeITAIUFT3TbIrIpADOVVwUhFzQsTU",269,350,315,665,52.63
"Xisk","a7zRF9PSz5N4l6QAkfBq0aoOGSkjVE4AQiMrdkCvN153DYo",0,150,135,285,52.63
"TaeyeonSAMA","FLWtN0JHFAfpVVKTXif5Sest74FKexXTS9ZjiX62ZEhoe-s",388,150,135,285,52.63
"HunterKillua","egu3EToLMHp2UYHDHULY25gvgTrK8OaEmOWFIBZr3Sm10Gs",14,382,344,726,52.62
"Zefy","hmi63kyIs2oooov6Ti8ERGEgZlwE48cnD6317AOVIiheP_0",327,462,416,878,52.62
"Metèors","snHFMOPEym28GZgHBnpfgg-ocaTx9GRcKCRvdP6djBRNf3U",260,181,163,344,52.62
"Eav","3gxypla9boBfk3_KFYWye7-YwxvEZNwXeQSF6rhWYusBLvM",114,382,344,726,52.62
"Jaeger1","wl8iGH4t8Ophz7kE6U-00hjsqohr3fwnYXvrkuZPwT1QiAQ",0,221,199,420,52.62
"Primochíka","PY0OHak0M28_klVw_KZ4T4sa9tLNHEdSEqsnhgSp--tcObtm__G-J8bTdQ",1,151,136,287,52.61
"Wberyleg","X7R-Bzuxiw8_g-1LLTAo5pH_6VKi4t-rBo9Tz9JXUyn2A62YGLh6B8LVFQ",51,222,200,422,52.61
"Coryonsh","9ETIUSaWLv4iMDiFFWHj71cCZy4n5f0JGZPM5MQhkqpRcOqANHsKcOPLaw",202,141,127,268,52.61
"ymzkvgt","bIDIi6KT-oAEWE6tEj8x85LnnAoqY-8nBGm2PAotA53wOpy4pc25NECJaQ",103,242,218,460,52.61
"GGanBu Capt","IvBO8JMhyFgTlPc9n_3pjWYOtE6mDY_VTEc3dmJBeqIubGw",20,91,82,173,52.60
"Burza","sXE9J_tpXPmf4rLLE7lUCgA581xu1-pXzehXArai-fNX2CR_7-yQk4Ny1A",324,384,346,730,52.60
"ApcccCN","vOafrwP_SKnstAfmBW-rdbZ8VYrCkzq00mc6PegrrGElVCWm",250,182,164,346,52.60
"Nestley II","9_8_G90lvAB6G24CAqDcVlwUsBfm_01Enz29Pq2JEJMStGyGYIPBRWe22g",348,122,110,232,52.59
"Jriggs","Gn60Y7-lbUXtRTmIJIH60bprDxYAPbH0C2V7v4GNc6He-9U",348,122,110,232,52.59
"potatoBlastedMom","y4D8QW-rSiZDezRqG54eOvurSnUESo5qmnYBBjd8-GzKsucd",488,548,494,1042,52.59
"claptrap21","7i6g9sRXOerYBxWEcDCPRx6A2n7S0R5NVoZ8yI1nxXncaSA",292,447,403,850,52.59
"Tippey","Cgyx-pfg4avMjxfsUOCVEjUDfWMnfCD0OunQQ5OVaIU7z8M",324,122,110,232,52.59
"Infamous CJ","DU0FGQgWe9Hin6o64SSApovlZy5fqbriRYZ1ZkJ6Pp92rwQ",124,142,128,270,52.59
"02 03 2001","GnhsyT7TEHmxlGWV76T0xfbiRe48EpxyD-QXPYE8S-tVv4k",101,428,386,814,52.58
"yomama0117","DpPExVg5mNf8WWSHMEkvXbi_KR-aOz-4SlPQE_-fKdH2nYs",103,234,211,445,52.58
"Dragowski","N5FPOGJJ-kBpteQR85c-0UWbGLVwNRjw6dKZP4yFOhlR1OMo",0,234,211,445,52.58
"gaozi","gW3SUYbf7_HTKpEdDaHh1NNg0UUB42cZ8YLPFBOKiOG1hng",332,214,193,407,52.58
"Sadlyy","qKB_lDLSSj_KmBG8MRrI61umPsO0piNey0ChDK7a-CnHhrM",326,255,230,485,52.58
"harder please","4lE2JjT1-6zTrBfHDrF4wd9bgLifjSCkQX22R5RPIQoLizc",178,184,166,350,52.57
"MeatOnTheTable","MSJEdtADvrQpyqKvIqLq8LQ7RSSndEQSX61nKGl6WyeJa9tf",119,174,157,331,52.57
"Mîngle","oje9vUcy243OtBEPbPUmLvhbLOFAOQI5KiULjOrz4KK2pvQ",1,307,277,584,52.57
"fSHBAIT","iXuFMgxI4CWQ0XoJgVSDEa6aKx5KJ9NF9bdPnpGv3yi6-LE",76,194,175,369,52.57
"Retex","g0VdY4dWdwnL-hi_STDuqx8Vve3906STXFxdIW-B0OBG-Qk",264,317,286,603,52.57
"tortwig","m3oEYEdr4x2isAnQrNVrrAgH4n1T3KT1vnlOEV-Oa5o_ix4",147,225,203,428,52.57
"Shaminion","2H80mdqQ4MIbDJdxnM-saNtQW32FUrTwmOka0plvcaANcdQ",210,225,203,428,52.57
"naim16","LpfalWhf2IseW8Gt32Z8DtLfLON50816zD0uOzDSH26n-Cc",97,174,157,331,52.57
"YSL TANKGANG","YUZ_dmUAUomigxBtl5Dad6ULCuC6jS2gDEqMj6VqSLQHi1w",96,154,139,293,52.56
"Im Stan","MmhC17mCAYKJOKeLN0VSZBX2nkHvpn4PZVU4p-FDVPzZRn9v",15,123,111,234,52.56
"HaoyunXiongxiong","Q5J2RMVMxCl3TNDhXCGx0WB1oCpqT4edfTudBFgx5sFUCzE",217,185,167,352,52.56
"Ominick","PywceoHrFpDOHyw8tFiudxJQkLBrqwWwtQQXYcx12wPMnUfIHu1aBOtYrg",282,433,391,824,52.55
"Shun Shun","ljCa8aP_S25xWza8RexdmJBBRYJ_wL2Kycem8U857QWuRgs",57,288,260,548,52.55
"Joon Hyoung","slxpjNGtt_8eh_DX6NW9kpkraQDTTcCghc7bFPr765QuJAk",402,134,121,255,52.55
"Little Pawn","xzOuHhSiY2nnioIHo00D8KPIzPjOyoFdbE_PrgR8au33bDk",118,144,130,274,52.55
"KendrickTheLlama","POKmQCk3bKG-n6ahmlkQa8Trlg_rF0IyUs8iV-eBIFc24k4",1,145,131,276,52.54
"TypicalUnknown","_Z-18M6c5vKg62FxHjYwS9fZyWrkBw3d0mne-aAsGU5_DoI",103,352,318,670,52.54
"ladgs","WUws2-aDVQcUlLqtxZvEg9-8iPhGubgZ5DrLHSZYQPQkVr5HOdpU6fRWkw",62,217,196,413,52.54
"uhh yeahh","syF9ReQz7vOfNq84Gofox3PruhikZGdFqqtqbaX7uXV_lN4",128,114,103,217,52.53
"Nohova","eFsvY3BVZFW_nkYnVFT3Bzz4XQ88EP8EsKQILwebWtxDExk",79,228,206,434,52.53
"WU DI ZY","vBHqZkCyMcTngEXl_B558O7B0NtiSom_aG-ADLDVjEssY64",241,508,459,967,52.53
"Wadenation","ZqlL2cE_U3_qBI7nsxJRjl4bxKWPZkJmq5csETK8bPNCSs8",174,301,272,573,52.53
"isdragon","NjjmF--3bM8J7Nchs6HwemKQ8kDwxrMO9_lFifNTxTiuEQk",281,322,291,613,52.53
"Berenthal","oPNGgOCzBtcdU8FI-7DlLzKI8aro8B2Sb_tSjcPAOzA78rhw",24,425,384,809,52.53
"Zero Nightmare 5","OS8eL-WwqA7sUgYAkDvDydWV5GtQyprrtXk6lKBJYqliaNG7UjiXtBpWbg",44,135,122,257,52.53
"Arcanghul","d0v0KY6wx2lAh5-U62wcfDn7VCZJsSM1DIV0uigJPQy0vrU",474,334,302,636,52.52
"happy game","MDqe7q9E-b1NpnwpyHvdANg_XmsyaMRbHJlU5L64sv2Km76K",404,146,132,278,52.52
"Valantis","l7yZzNINdDvGCul6X59DA2DbTcoAE6AW27cIkkx7ww0ug-U",339,167,151,318,52.52
"TONY FERGUS0N","D3uuyOOtBYBvrqwSAFD8PpJAe_bnQQO7D8mkOAbEWowBxntJ",181,230,208,438,52.51
"Doctor Scoobs","2R-6RUo637TDPX1NynlQYwRM_DftTv5c5-Y47mrO4FNFH_8",208,178,161,339,52.51
"Fiant","MHUu8iEjZlemyZBQkWiZPtgl877TpIq8dWv-S-91smbnz2Up6tXteu-HCA",456,188,170,358,52.51
"I Reincarnated","_pXfU4o-fl9pnHCgPVWRNw2v-DiepcqY3psoMzYI9gfQo3DT",292,157,142,299,52.51
"ItzNotYoru","EvMh-zs9o6nP3ckaZIzlV4ulOBHJMsEBNL6-RQZHq-trdVvk",281,503,455,958,52.51
"Yí Lù Xìang Bei","6LSVbhHJjLMo2zEyG7NrVjPh5RvRF-jyka5vQR8vIrnlV960WFusGzFGhw",208,324,293,617,52.51
"Renektonn","oeba2fta8kCVRrR1CD9EDBYlJkuATxO0v8p4ccUNzhyEnyc",75,398,360,758,52.51
"Crusher9654","Oa-JhOxPcywy6zsIdATsdqsMpeQyehOk80RcDunEg4K59Ug",1,63,57,120,52.50
"xiagu wangzheQAQ","AKZ0S-8llTVos5RVXMWG5rawTBySW22a45UpjA0m90AY9Tdz44xFvRnwFw",56,105,95,200,52.50
"Muslim Chadwick","q7wWQPlRuz8JDD30L6oRVRk_RQ3DItzVfutbIaQm2gLMYpvb",113,253,229,482,52.49
"HowToNeeko omero","PlrEhvcvqkamPROF8n2-6zndCMreMs61uGbF5LGLsRKMYYY",491,253,229,482,52.49
"Olux","7i6qJgRBC0v1oW4SUstzBO6Z30AnKFFhmQH87wDLMXdLdO8",344,137,124,261,52.49
"GilgameshLoL","hA-Zo8b2JziLYTwuW78PhYimoaL62XcMIEZmgH1k3-8oVPr7PxeLQp39bw",63,211,191,402,52.49
"cuhm gaming","9IEQ6I9AUK52joHQcxPTEWivacJi8SBdCim74fs-hXpyP0E",125,422,382,804,52.49
"trash panda","e7xHTbheIoZJZJgd-6fRweCjgcXORyPDyR7D0Hd8gO1fe1Y",420,338,306,644,52.48
"I LL WIN","vfyFHODZ41iVlqRMuuuXDrV7C12k4RyGSkzUwbtb6eQke6A",455,127,115,242,52.48
"pooplol","wOCyjQN2G3UExe_GvObjLcq_oGqo-kSXK2njmvX9J4hwOfY",61,360,326,686,52.48
"adc v 9","DofYF-NNCYKgG7rlP8JN03Oo-q-Kcovcmv7TeixO3WpPOijc",1,74,67,141,52.48
"Cannibaal Kevin","qdJIm1g0VIGCUU4P527m9k7dUtHvhl_qkCUaj6eeVAPGgH8G",319,275,249,524,52.48
"Jaymoper","DNp1-rTkue5OpxuX1wV5e2pU1bZD9BtwurY5uO4xkxSut7oeqCMy1GNzQQ",256,234,212,446,52.47
"X Nirvana","P6cIkdfg2d8isImjoAPVH9AVbEXF8syK2S82_PD9tG02Trl9XFspiEjJyw",255,85,77,162,52.47
"Kuai Le Nv Hai","lJDrgeVBih-e3hgHZf1uHIW2NGo6aXoLJObosBpXunUmrUI",17,626,567,1193,52.47
"Stars Guardians","apGrmJLb_w3NzCIZlqzHdHejpHgZnlJ37lEi7LiQh_G_6Lg",62,234,212,446,52.47
"Sxt Svn","lEMDbtGKCJrQpqnUbKrv1L0pJjuTLpqYiZYTkM8Tp5LCukNH",408,255,231,486,52.47
"Sayonara Vince","EaQmBau8AeJhubf6np3g7OWP8yHoaa__8li3RsnFmZ_mBf4",181,704,638,1342,52.46
"Dréamo","JPi5Ezsk-y83sQNlH-V7oM0OywZlTQsppWe2LOLq4bUotAg",346,235,213,448,52.46
"OMORI Kel","N9U2fWFf4yM1PpmXm4kLve33FscPuL36F3pFBjSDiLp8m-x6",1,511,463,974,52.46
"Puertorican Gap","Z7FRrXgQYvqmMFVTRL1oJQ5gHRF5vIuZ2eOyel0xUVy45QXc",377,352,319,671,52.46
"Xiao Kai Meng","bN5IPDcROFAOKIb6uWGaK8OQm8sSv7w4Tx3YWIaZJDQhkL0",16,225,204,429,52.45
"korean dog","feQT8Apr9KgEEbjLEJ3LQajESUK7zdWhGRZMFcc7t9zvVTl3",393,342,310,652,52.45
"Candcace","aCYKdCcsZsIq2QZZ7uqiQBlTwW9x7biHzLMG62N0v8p8BTAs",116,375,340,715,52.45
"45p","hEs5bP2MnMDcCSLjRC2LQasd06mWDv0AA9Ck6axtDrrz3CO5",37,441,400,841,52.44
"NOREJOICE","LINVwB7Q1izj_WU1aKTY4ANKEnGhUGtjrlxXd-f3WWY814A",1,183,166,349,52.44
"Kleptomancy","QGjmGJfK26Lnr8oB-wKIsqpIVCBbviDyfLklQ2P_2YrOrNo",1,366,332,698,52.44
"Windhurst","0dGO6pQRS_5-RiqnLZZ3dD4MmfO19TNj9n6rz_VNe5gHa3Y",85,279,253,532,52.44
"CR WarGod","gZPYvjnMadRQe5Now5gDP5BXhgN3RWwO0V9SMGrMrdMhGvI",139,183,166,349,52.44
"stn","V53NtPePHvTbfglJzw5lz3se7fEOZD9mAHwCTD3O-toIC5V9",411,194,176,370,52.43
"sucoH","wjYcCIaDLUKmQNI0OltgTj8kbb0vWD16ZbBe38VAbt2h4w0",377,420,381,801,52.43
"Karadyn","_lcWVv71PAH9UF771lcsm19ZkxiJ6iAmkZD5QueQGXKQSIM",1,420,381,801,52.43
"Renfis","sD0IF5Qw-QJq5CazCZRd7Zg1cekC-HGyFfgJQIUZNEhQhrY",75,271,246,517,52.42
"ye22","mlMc3fprcExCWigCXcLmUv5nCYfc44xsQPkfHoa302BJfBLa",60,260,236,496,52.42
"Stepan","lTm6cAxLNF2bCQc3X7lx5WzV58Dq1porewtf8-_nG5aLZxY",481,195,177,372,52.42
"Kklein","7lopP566COnKsK03pykFBVyUahYuVCR-of0RiQzJvOSNHI0",302,261,237,498,52.41
"jumpCCburst","ho1VNubCJitnu4FpOuArBqcaRVl9HYe47jZFJtUkv5zL8FHW",195,185,168,353,52.41
"Ørca","vEYcNT8lab-07edQRh2ezkvzbOjT79HC1ej6bUqP8taUemQ",337,284,258,542,52.40
"Boofenshmirtzen","n3ZYdj4aBzVaJnYPvPPOVH6p4zNv3mZEhYNzzRiPJl3ppnY",30,393,357,750,52.40
"Kuderic","Jrbxjs0y4E8nH8UvVUR6ErtGgsQB1gUB_W-4imgzuE0jiqc",69,120,109,229,52.40
"Liám","TkSTOxu5iakEUDxcd7I6ODbW4k9yJ95gQYSnXRdu6DssdDk",226,262,238,500,52.40
"Onsen Tamago","NPxHMNQRsLlG8w_YPWoDu8BcyeFJi015MLjWuYGT_YF8PCo",314,218,198,416,52.40
"7w7","CLqLJQHw_LC7SAaIXzVY21jSklpgpHnt1Mip0wsxL4qMJY8",118,120,109,229,52.40
"deadlygrimmy12","RUBt-8AOhVNB5mclEDtuC_hvyj_gbmxrA8MfrzZA66Wy-K8",162,316,287,603,52.40
"Long Haul Paul","pOKhlPQ-RRZcwEZMfIOVxzNnSHpuxaN2VN60jgp7k0DDcjs",189,317,288,605,52.40
"PillPopperPete","qIo080dQoY8YVnwquS2DIYBIDZXoHrCWmM9v0SMx9CmJ2-0yX7aJ7_XLug",120,274,249,523,52.39
"xiang ni kai xin","7aAZdf9ZpcTl4TDZ090ti2IwkHw8fCk9-krjeuOLvxYOfpkF",435,198,180,378,52.38
"Want Liberation","obPA-lho3zmcfuOKCWxy-c7tsL21pmW_rF5OoHXz9hWIPvS1R-Q4rfwXTg",260,99,90,189,52.38
"00006CE5000054E5","cgV5ZcIjUOZE3wp25sqAr5GC_sKChbWNDqyhBlUqESa6v_Y",277,77,70,147,52.38
"Armorkingg","rxo7DVaXLC_a_POD2xGTBoPqZTGAp7WxNgSPSHmekYbUceYfQzUOBH3VAA",43,275,250,525,52.38
"The BuIgarian","TGmgtW0xepr_FMd7szZY0YkpFU-2S9FcF-rPR2k8s2vCEB0",192,330,300,630,52.38
"m1xg","2ose42M9dN2s2YR1w3SlD5eJqhx-39f5Cm9yWh_FEj9ixpc",145,209,190,399,52.38
"WeKoohBruh","b2PoLtlxd33NhBCtcFUb5STx9ugfTKX9Jb_vTgIeItqUIWk",305,110,100,210,52.38
"snaker3","NeeVt7WaAzA0hccV1-h32Z4Ve-MmiR28EIsrerSQ8ymGbpW9BQbvMLnPxA",383,166,151,317,52.37
"Plaery","KMlzaFE2-11nk4nXjUVEc0dgiudawVePEGvuW2YYIRWy0tk",24,331,301,632,52.37
"Hey Im Scooter","FaFox6PCQe9kOJ4bmkxfzKg13biBQTnBj-1SGqQvzVvK",16,232,211,443,52.37
"Little old hen","AnoTcWq6VD_ySNJ4EV1Rn7Y1SmyKQdmOeI8r4Ov0DaP10-A",113,122,111,233,52.36
"St4ge Fright","XN8zEYw0T9LNTAUQxbxmlu-MTrh0gX9i8cBZgeJa0g2oDVI",0,322,293,615,52.36
"Ginqal","0J6repm-TG-UkSJDai90tIgG8FEDn5Ltu9AISje8OXrGENW0",326,266,242,508,52.36
"Curas","Om_S4NYfTQYWU7t-ciGkGDansVdyMplfdmnbt_amEp_2G5s",31,245,223,468,52.35
"Dacnomaniak","Q34U9BCXRopVCANERqHfXdsAK15v8Fj3JOF4qydXypa6aFE",92,345,314,659,52.35
"DarkMyDearFriend","lDk7mTTF5twxUpFKjTUH-NKK6HyPhGQZJxkvBd1MuKhKJVw",15,412,375,787,52.35
"canipi","ghzwXR0j_nz2KiaOG9CzyScux4BXbhZ0y7WCSrEDOGp5mUY",401,223,203,426,52.35
"High Grounder","1pwvyi3EybSUR_7Cvtx_1AAD2cKSA2cGPOEZuB6nIKR-PYo75Q5oFIaQ3Q",183,435,396,831,52.35
"bazzzthetaz","lbWckg7k8qkqeqti606mOQzyCPB0BmiJGhcee8KyktGD4MQ",22,156,142,298,52.35
"Doxa","FPLVsWtwWhH1yLAiDV-O6cDI5FowObAFAkoXLu1WSs-qKb8",280,334,304,638,52.35
"KOSAKI 0N0DERA","ffcx_Ss8AuNt11PaaBSWPn_w5lYArHxmoy2zFSVbZZ0yc6xNJOAD2uceVQ",67,179,163,342,52.34
"Tellur","XRfp6LFyfINBIDdQ_d_hwaTpcsMUiyysybp38j3hdnJmc30",430,291,265,556,52.34
"Navir","UMOVA86CYYti6pJin2r2RS3GYIjB3dD45rMlGfvHT4r4DPI",258,123,112,235,52.34
"Kertupa","HY0y-RUevGznWEP6Edg-RwDjxepMXNt-zhDiSlGzKUp-F97p",59,347,316,663,52.34
"ADC ShallowDream","iQZohNCSO-J-Va1g8E19jOdf_3BDO7i6NNsID-DpQgNcIw6o",253,123,112,235,52.34
"Dyson Sphere","5en82Ac32YmEh2KdIJrI8DqiYWmoircg-yTDVdZ54WxAEIc",81,168,153,321,52.34
"Ult Unforgiven","OvhKeEmEip2bQP4kSztCSpgghwGDybB2mUg6allmfoEOFWQ",248,168,153,321,52.34
"NeoSporinToGo","uv_OUScitDTTHKHsKDkjk2BAktrTOI-lmx19sEvas-qpbEY",14,235,214,449,52.34
"IcathianSprinkle","rRCK0d9y-2FwRWwN7dfwoKXrxhJJ8I4zqj6OOowNN_PGdTf3SN8r1q12Wg",125,314,286,600,52.33
"popsly","9CEeD06dz1vi6pZDlbnLr3SWnG7GCFkNJ8FqYDiEAnr3-tw",99,900,820,1720,52.33
"Meruvale","tIan497gsQ-dPhyEP28DL22nmV1ZjDaBFgJSAnjcQviNMU8",52,90,82,172,52.33
"Jermaine Cole","dq4i9-9z2T_gTDZw8Bc7UgNCYxQz7wLIis2bGop8d3-6CzM",199,516,470,986,52.33
"C405","wjoCv6YJlCWWAMMxWjougMleAadAtPhdpKA6o5HJHY15cZs",20,45,41,86,52.33
"Princess Jax","3mSU3kmnaXdBcTXzrD3rw05NAblvbXDba-KQKrNbqseGbHg",91,269,245,514,52.33
"MechanicalPlayer","5HNiHn85mFh30hgeBf_tDjO9kRFLeMpUwzCJhJhk9oNdeHY",248,326,297,623,52.33
"Sany","_JoJAABkj1yWFUa-d-jiCVeMuUAIxRPm2f3j8T0RQ4XR4LLQbuJdld4Qbg",248,404,368,772,52.33
"Stinger7480","X2Km-huhHjGIOmFotWHVPvFik7dO-_ZPQ8oz87B5jXzicow",51,259,236,495,52.32
"LightNReset","eYZD0FSbMEgbjFhI1KAn-zJUNDjLTD6R_xluGK8p54b-EjE",35,214,195,409,52.32
"SirValkyrie","mLaIF2_wY0g4sK-qrPg_Vf9U3n8ske4ShfH_5bItffcPjNA",19,79,72,151,52.32
"FerociousNerd","uXT60QIC5sxZTqFXI4ZRs-laGWbmiGhvvCbAsEFLlN7KGHg",1,394,359,753,52.32
"BlitzoIogy","7yNIbM3WMbWkJBUbg1IoRWhVfDWfmcKid7j2gOTgvPFRDco",75,203,185,388,52.32
"Griefinkstone","1V4WIUdUHWBzPkM7pne2J8vS46bG7ex3z4MCCOX8238yrt_asA5lvXMhMg",247,136,124,260,52.31
"Xiao Xiao Lu","NzDcIrb7CMrviZZbSEYphSmGLipQgCjFuRwyABKuQ-YGggA",102,328,299,627,52.31
"xzz1cx5vn","7qKga8aacxoKdT4IW42Ckocd_YXouOHSU7-D178etyaWnxMT",314,170,155,325,52.31
"ADC Viktor","KyyAnz4aS4JAkDrBzNPuVatokw6jxTTCyH5pKd1bCNA2iz0",397,339,309,648,52.31
"yotsume","MjM39KZ5sG8zAoWEPQpoEQ-gNpDfp8oi1jc6-VE0X4T6NiNg",52,68,62,130,52.31
"RexQu","t2e8ISPuqnLaEJsHWYzpKscfgjbTOYkpiJ1w3aTq1NaXPw8",445,328,299,627,52.31
"Unknown Emp","K208Qb6v1jXzM8DJWCPdEB454dht_Pqzzp4jIFI5TztWz98",397,125,114,239,52.30
"Absolutezerohero","FRvcJLcRC2ivTFU9bCIOlRzH0kJ7oCgxizWFplUQwI8thgw",252,182,166,348,52.30
"Get Carried","pMofLR5U8qnscUqb87-8YP-TvRZB0KYEd4GAISYOj8r6alM",1,273,249,522,52.30
"andrxmeda","rzwPk4ykfqfAagIxErNvTaW3fbcpS3CHDEAztz8Ua-Gaugg",213,91,83,174,52.30
"Vøltage","jdy50JhGNMpWkbvgAWUj3-deBCGc6XwkFoGV2cRNfaVkhws",28,262,239,501,52.30
"Jeanne Alter","aYd2uosd0o58fzPQyqmkEsQuDPTxuK9nia3kDTY1ew_TL3Y",173,261,238,499,52.30
"Gristlestick","KINs-Fghl2Mg6GP0B_eIavwkIpaZjGbU30UfEpEgVpcxnuk",91,443,404,847,52.30
"Eliasey","sZelu4u7nSsOc0nOPRtRYZWlPEdjoUngLV1ymdVAjdODOhg",408,160,146,306,52.29
"AH Illaoi","ugpVEAyEelBqTOJw4L33SYh9n2KS3KW8YPuII-wXhVMCTR8",314,343,313,656,52.29
"Rikkeu","2ZkvUCbbJCTs8M2CoHAvJzxVneE3865ZTMR9m142nQtzsvM",324,228,208,436,52.29
"Márs","OgZVo1LFhVZ0ozYxRHdL6kdAHF7_gIeEYqng9WzWxXyMWDo",353,274,250,524,52.29
"Masterofcookies","HD8gZRyxGye8aNuZLD_n_eSeeTPWx7Bg753C39M9vzyoRd8",35,80,73,153,52.29
"Uoneyandraci","iqjHfh8sSXw8I6LPXKE0gj2yUdEC2y7pjOBix_TbctpM-ARKuulJkpxtmw",61,274,250,524,52.29
"Bai Lan Xiao Zi","UMBjNrcDp0hnzRVo8AXjaU8cyVdPb-6JbqRRUpxZiH8axfs",138,80,73,153,52.29
"ADC 2022 LuL","3JG9wlYLcGd4cXn8FjHgiE4l1PA-xxFoEZKr7mDBdvKmQa8",149,171,156,327,52.29
"TRT Yuumi pet ","HFkxJscoQQz6SHgvyTkgcnqZlWEHIjcwhUHrSEqGaOEYsQY",462,172,157,329,52.28
"SuperEdgyName666","q2TLbPYb_AuN3vC7iv14mfs7xS7_8De5Jt1bhE13i11j0yM",39,517,472,989,52.28
"Only ban Lulu","Vmafek1QQfpOJBHZmG7CIVkoQpNk2IOmpDKjoeddaYfcvO4",42,252,230,482,52.28
"KENTUCKY KYLE","gZtHydnIX0HDj17bv_BrFTopDpzsflwJmm95KNkZ5n7KGkc",0,402,367,769,52.28
"DAMWON BeryL","9HDk1uiougCpUtgRpLASerJarxwTnLacTDA7v0zjSPtGL7A",1,252,230,482,52.28
"DexMax","LrgHv3APjbx58VLjCSBL6Y5xo-k258HASRuWpVbBPH0AQ7U",20,458,418,876,52.28
"Abitibi Papi","t42h7EtM373p_wxGXQuJxhWFenkx-IlhtrF6csQ7cy0vbMD3",283,161,147,308,52.27
"Rendevious","kAWkn36rTZ6bwQ0CrFLY4oGzOukqsOArOuY-7ozBaKMLByV7PDRu2eNp8A",1,46,42,88,52.27
"Winking","H8F-rSpd8--f7M7c6kF2TLxXbpyMJ-ncqmgBzu9N-b7X6NU",180,207,189,396,52.27
"Lord Snap","cM3ywl8VLf7JbWYX4NutEQAljyf52Da3SyoyY5Aq-DVB7Ds",14,173,158,331,52.27
"TwTv JimmyClearo","ysVpKJkbbpk_Ilp7SgaIgRvpi5tdSjfB5bivBArG-yAbIkCE",142,380,347,727,52.27
"Leidcrop","NEm8Ao7gbFvhH-gtsMMjzSR9cxmCQG8oqt-IqoDdwePVw5o",287,173,158,331,52.27
"putjuiceboxdown","rKXOksjFWm9BIH8iwB1g3zecE1X4ny2a4V1Qrli_bvl8mdY",436,230,210,440,52.27
"UwU OwO Rawr X3 ","7tC_ycORr9zQFIGtCdesORV_bIHeTnDcWnj6lI5YrxrP5i8",419,196,179,375,52.27
"Skywardd","hIUjW3d1ESXnne0D-QB-nIch_FdRCKByxKWixPrPd1l0MOlN",367,311,284,595,52.27
"DieuSam69 ","fXpanl23Ln_Q6MV38GJ7PMeJTcR-IM3ABCkcHenOPiIvTus",0,230,210,440,52.27
"Daseott","L5058Jxz8f6HYVfISexAKwd-by3yeRv8FDaw1QtmYotD7E0",1,185,169,354,52.26
"SeiKelp","AHUrE0DTvCEWhgSQHtDsQI1woT3moPQSALefG-oaO6TlqmQ",65,312,285,597,52.26
"Sarin","RgljuavucFXjJYntPblt0tO3cCjyvPgMKbYhBSI7tQS4g2M",295,104,95,199,52.26
"2Andreus","aiTRNTUnrWDrv3dSuwnPLqQeuvRQq6RuDT1F1miINeIv8E5b",356,127,116,243,52.26
"Carmite","BLd9_hmRJQkqgU7wUBi7m5Hl3pXhmD3FxzGk9tvCx0kWOkI",1,81,74,155,52.26
"ADumper","9TjhkNNtTDqcfquyAX8hJOfAkwu1zfXdcyUqASs2CA8YZdLm",199,185,169,354,52.26
"1314520","08If7rPghhvcSiWMjLaWJvoM6Ut_B8-LJQQ2Ns8UOUtFT8Y",155,150,137,287,52.26
"Deadsesne","mNFEeBtU284Hq-v4DYfp0aKOJQgiU1YNgc8FXTqsLmMnutc",341,231,211,442,52.26
"Speakerzoid","UIHDpxamFJ9cM6ROVx8zHUSAUSj4gmhdSzbb1EidfvY_MV0",142,116,106,222,52.25
"Dope33","3HN6ObQFdTGYDokHAb4xl32sEj9-o5HLrXFE3qj_e1vqJoo",305,395,361,756,52.25
"Jawst","ZVYXC8Mc8GjAYjJ2Udwe64CY1Aa2mpKHPs5zM8CmPiUgaSY",45,313,286,599,52.25
"Mechanical Angel","zrV5Cco3Hm7m8LWGneFipsRuCsrURt_th5NAlfhn-FusMAeo",1,197,180,377,52.25
"lv16 is a lie","b1AjUoha6KyhWv_FANZrRsxSWpMTwuIinmam0y2C7Fcn_IY",95,465,425,890,52.25
"Debounair","QaO2kqFwkpP5IkDl-Tc9upnWSDWTP4ajtO732m0jrospRwk",221,116,106,222,52.25
"APanFan","h6nd2yyeprhYcaYhnER9LiB2VkA-aBDJ113EUjQJEBpJfI8",15,349,319,668,52.25
"WasThatHim","N5uxOR163d3cxmQOWHo45T53zIMgnKBbKLclkYjUHj7yRbyoL9HThqhP4Q",0,291,266,557,52.24
"Sami0","xoo6pjgwjXtZn2NDLYQmd2pOqIJPmsub4EGnpvsmsyjo1lQ",4,35,32,67,52.24
"WEAKSIDE WILLIAM","to-zkjhuQETPVCBFFHSjEHwEICOI_9ScMdKA_hE25MDi1CI",455,619,566,1185,52.24
"CR Lotte","aHEBi1l3_FilH_1A6j6DVmnYRcdZl5ocEpysgjjDYo4VBGUS",12,105,96,201,52.24
"gotchee","Y_rZWsBTZQOttI-AkuGSIT6X_zlLOXKVNf98SVJR1MVY1d4",92,140,128,268,52.24
"i wont","DHca3_HFHUp_JEWv7fWLd2Ghd65XXWIJLIaHGS9Kk1exyH4",316,164,150,314,52.23
"malaguo","d09GR63Rh9maOGDcuUtQbR1srFpN_haah3xI71Uji9drHPc",52,211,193,404,52.23
"Basix","aXp20GGkAKKPxiGi4zUGBd0laJDGq12HBfpxiaHhCUxdaQk",67,153,140,293,52.22
"ARocking","UdcvHA26w9S96iziLvHq2LWdVp_mzZIYeOHDN2jcXvDg7sM",323,388,355,743,52.22
"yohun60","12kW60om9ySvqvHQNkjDPLZhxwePRfSRWh5B3DCH-kmaZWU",47,260,238,498,52.21
"bejua","D7pWYVyQ9flDrqQgPyR8VlKL78ZX0lpzc5brJ5VQS42RTrQLNxLDR6XIYA",48,355,325,680,52.21
"Tavolicious","cxEgi_tSneO2MuqmF9Oe6VTxBCgyOS1m9DRGh1bz5yvugvs",286,213,195,408,52.21
"DoYouLikeMilktea","v8RoBsZe00JbB9INgDIiXIVXJTOT3RJ8TWb3I8hyPG_qK7c",410,331,303,634,52.21
"MëowMix","PGAPW4C3xZJLAtuWk70r7MMAFEwSf78dOpP3PM06n5neYIk",14,201,184,385,52.21
"Binyi ","bnzusOjzWKcA2hAW5BYuRYYyD6BN4o9RdWaWacW1P06BqWU",16,214,196,410,52.20
"m00seinator","dbcYtTlGyEsqGuv6O-pVBz_l81PtM2GBm2bx0AULhhUOHFc",235,154,141,295,52.20
"MoiraHearst","7Hy1AAhhcsfRtKrF0Ibdvxt4JrafXWKMPdFTxfjd8xAtq_ZtO9Th_VbzwQ",238,95,87,182,52.20
"Kìńg","uzFk0FmIJMrOJbvxBBf-G9d5A00GwNgMljBuLAIF3jnUckE",88,178,163,341,52.20
"Markachino","sj750ANVRcvp-B1P7XZhVUCx15mwdX8I9jE-ulQjAZoO9IA",32,214,196,410,52.20
"  rosie  ","hn2PGvb-hwqYD5faXQCmQyaYCiNO8Hios8EpCWBezXQVnNQ",180,107,98,205,52.20
"Jer Bear","V4Vd4Tz5_YQXLoMrnHjNXH_l7skkGO0-LzEzrUDqANKwa1A",235,225,206,431,52.20
"TTV YEKURA","cPad7VSdJBu9SoMaXbZMMskieYeLJz1fEC0_e0g7fFqH2QU",200,249,228,477,52.20
"RainaisCrazy","C_JMhPCX4rT6X_7c32cvd8LCWOeXWyTJWD-zoN_X3p5lyjU",467,334,306,640,52.19
"ProphetCrumbz","JQUqxC9L8k70sTO_RDX_jv7jW07okUwUeanCSRLWnoVTDnw",84,405,371,776,52.19
"T1 Kería","99mneDIKXNjKYeh2OBy-tPwdT8bFaowlMxKdf8PvQpvLzVc",109,345,316,661,52.19
"888","AmBq9hUS0NZYYxXFJBC03U9TGkva4a47xv7POSxFcT2v4gU",215,274,251,525,52.19
"leaf","TtcAgJ_MdPbzXvfXtzV6T11tFn2HPi5OY0XffCFm9_ydRaU",23,238,218,456,52.19
"SavVi T","RgXLVRw-Pg3JviAWwQ8MB9H5OkNu6dtyhg7fT4k5PnD_NVg",117,191,175,366,52.19
"Starfruit","J2UVYzBUUxjQufTi3XU8oP8JHjRChQH43u3RCpJ1wxKk-IM",2,191,175,366,52.19
"501","2NAAXYsLqoQq7iHHxGCyl4l8SVr53uHfgJbAzrnO8krWCnM",15,358,328,686,52.19
"MouseMazing","rXbx0JSd_aiDRgwdnNZASW0r-7g67hQk52DzKx-rMVPW0oc",260,287,263,550,52.18
"lTHTl","IBBmTQZ2CQF920Bl3C7PYo3CMV9fja4VNkA81QqOIhvdegM",124,263,241,504,52.18
"Phazè","O8HUhgLKiB1wiswdUxDM_1c415ggy0X8Lqt2FtSCnMLIoOjA",34,646,592,1238,52.18
"dioxide1","SRcQ-KVaPQmQQedQkmwOgYghnHb1b3BwSk6P_CAO5pz8joo",291,204,187,391,52.17
"Killerqueen fans","jk9kAn_WVWy6YVonkki9r305d88nYyDV3HE62XT9lX167r0",263,108,99,207,52.17
"are you waiting","VefHocK9Unzz59rAqpSIZxkNLsKf9TNo1YBnCbeuu68e8cs",205,96,88,184,52.17
"kxbe","U4YJJtEDwkv3Rh1xpPFZv4IIpiF13l3W_nT2x4Rftkdd0GIPn7nnASl19A",89,277,254,531,52.17
"hailuaximuoi18","DYwtY1XrcDgp4bC2b4vK5LZpi2I2VIJJBMOqHN-yE_92NGXp2eqgvnme7g",78,336,308,644,52.17
"Banded Dragonite","vh3uoN6A9wWbgc0bUDaZlK0o7LwE24lf9ntZxwGblK74X_n6ttzyMeMZFg",52,384,352,736,52.17
"Champaign Sunset","XnnZ3pfP4qbt18egV-oXPkjrhTvgLwjaa_enRrMgS94tbfq7IRS_8X7Vtg",46,120,110,230,52.17
"LOA Enjoyer","yYeggSg6gkDRLLQafj-BrdBMeJAtymqSmcZUhHGsIGwfsOfGMjYytT265g",198,84,77,161,52.17
"fillnpcgala","S7NM2kJ9bOLjPVuHMRrwVR6Y0u_N9CcThiG5F7Eru8W_0dTU",121,72,66,138,52.17
"What a noob","NHuV7IkFJV-Y0rwrgxJFi75VRFGhZM2W5wpPScngKgSYrpU",361,336,308,644,52.17
"JusungE","aDbWyggvrjGKtEuJ96fM3G8lxe6--J1st3vETU-lysgQZulOHAj5rY2Suw",86,145,133,278,52.16
"Sillysiddy","UtM12RwElK6bb0IAsnuyHwD6rTJ23roThaTkCmFu_byzHaU",91,399,366,765,52.16
"GhostToasties","_YFYO5L3IuGuFozKNUb10BfICZq1BYBkyL8_hbZOtPEyeo4",399,495,454,949,52.16
"PANDASANDA","u_E6UQfQwNzOw4z5-x97EKyRqPXL0adVEfjYlai3Suf-xE8",8,109,100,209,52.15
"Turbo Ultra Bard","3Sm0OQlv-PYoDYFdQSOqnrX5bGLNxTY8rrYbAF2ymwLa0TQ",163,412,378,790,52.15
"oKyler1","PzUGhAAkMhH3lFqg9rQX0CEGxBE2iUcUeorS0omThXZ4d0w",215,134,123,257,52.14
"ChocoPockySticks","oZ-fnjUG08cs1B5Z4TGHdTT0y2ymBMP1uDu9oQOdb2lrO9Y",66,414,380,794,52.14
"Sweet Night","3PTdLIKYb7rJCdAppieBAr_Aa4VI3POdyqWSh4I1t_Rk67xvf0xvrpVRVw",7,134,123,257,52.14
"WrongHoleOniChan","T0fpELSnAcCHgj1IK1Q118GJf6IxzwKp9CBkNm2c-yMzoT0",240,146,134,280,52.14
"Ye He","-W1-1-3L9OEUEszKUVmkkfbImycpWVELhMaSbyU_UFBl7Oo",294,134,123,257,52.14
"Soünd","04eX11cHyL--0HTE72F8N6lc8rSc0QsRP725P94lnQMp8Ew",203,391,359,750,52.13
"sorawrs ducky","C_NzBohLSEIbbHkKLbuTRfvsbzgePEUhuXYZ6AZRpmmiyyNV",202,417,383,800,52.13
"twtv Dziarmaga","QNattI2S5y0x4MY8qkquFy3tc3XAFdI0gYY2QR3fXrh3O4E",371,466,428,894,52.13
"Lil Pow Pow","_u50ihX80O-4eMzH2oyJ3kr63g9u9FaQ-5jiUyJ5e3Kc86I",105,318,292,610,52.13
"Unluckybreak","hkK9GXCCU5_-3W0p4dfcESr1bQKezl6QeUpdMy56Klsycl_SkYuLvo7SrQ",21,269,247,516,52.13
"TSM Striker","MAi-kLyYFe-EjeMsGHgpWyG7iZn0wlgcOhw5lYE56W0enWA",1,611,561,1172,52.13
"Velenos327","XW_LieQX3A8aq10Qt5EWWLCNVPppCarC4ZX5ZHebt1AGhQAR",115,367,337,704,52.13
" roselol","rebjCsH1sVlnoEQ2fcRv-2u5rF1NImOb9Fe4_-9tdzk33Pyym4rT2uRUoA",74,110,101,211,52.13
"senzawa gura","c6417f1UhTLTNhvpmsDtsKcG8goFE6l0MoFWm1HwO5e9dD9v",70,392,360,752,52.13
"CellularACE","xQkDAfOJwoNTJ9mf9KWxUP01RzM6Zkkmpp9jDwmVBUi-DJo",1,355,326,681,52.13
"Pierre Gasly","T5RqUlHnRT2tdWrk189wDPnZ9eUZuANWjaAfSkPjYFPQIiLg",139,344,316,660,52.12
"DãnDãn","j4wdDg64IOf0C7N-UGIksF-x4sSfce4QYZiA7BHddtVuj-A",212,86,79,165,52.12
"ba dian bi qi","FQ9N-7MT3eJ8g6_3Xx6yFBW5R3kU-OjbYSlFqtl50aFHizFY0W0COzIGjg",275,135,124,259,52.12
"LF Fresh Acc Duo","oWp5He1-V1lq-kfnbDYT65Tlny0P_bDKpH7N5WGA8usB4i-4tCwm20qK9A",432,763,701,1464,52.12
"im pretty glonky","5_V0AMGwCNBs8GgGKoCLwFGVNN08Sj57PNTz0-Btmyffl2g",0,185,170,355,52.11
"Ambitieux","zy2e0TDrfjwXyXq04a6vTZr6UZm6AyiZkuFAY56SljtHDDg",351,198,182,380,52.11
"Your Acoustic","wy1A4_LuvHN2nC_ofa_LNvq8SmH0pdKbCsMIr20rE6-BmoY",432,148,136,284,52.11
"piaoGG","tt29BrGXSxomUve0SaqlpUgMPfBnpuWVZkdj-fNnYOSpUO_z",208,544,500,1044,52.11
"Anotherhope","uGrJn-9L49xbkt_WjQGqrqqk_F68FRx-iMHKeZ5XNtywnN8",356,370,340,710,52.11
"pick me up","SPVtafaXrK_sVT1gHS6yM6rnYfirAu-7g2ztvCs5Vhh19rI",59,99,91,190,52.11
"GhostKnows","PenwrCahQmpVTo5a9ToH5g0nniSZtygqDnaDPqUOSodTo7s",1,111,102,213,52.11
"Coldfíre","cdB9rGxcGpx_2bc-f6J0_ByDe9CFfRq4WiP8EuUmfgVFYAs",0,408,375,783,52.11
"Burning ICEY","WROoqV_9K8ONYgbFzZAN4WBCaPPXgZKXhWILLD0QGM6EwQk",17,210,193,403,52.11
"twtv Sepekuu","3gi_9bh8YtwUsJBvDqlQMkgTBmd0ihX3mFii7Vcg0Txl5XU",466,247,227,474,52.11
"Joyish","G6auoM5n52ljEST1I_bY4Sd0KmRuuNW79uTFrEt5ujH-PN4",57,149,137,286,52.10
"LGM wu","G9NrWfKUBx4UPZJlCBY2rGcVUP5PxCTHYc85MmOwI90xun4",155,149,137,286,52.10
"Ima BarBEARian","B8ld3GHLD-sEe8jyg6ATTke67i8MCha0nPPjlwRP_nMf9ZQ",206,471,433,904,52.10
"Graves Virgin","ayGXiYjJHBflO7oK28oqOf4LSH43bCvJrjPzqoE2sr_qQazZ",327,372,342,714,52.10
"tasukete kudasai","Dqr1GlMsuQN5R7UZ_XQZDKClZ4BvfG8-haFOdzkvmmqvaaEEoxBd-a-xWQ",320,174,160,334,52.10
"Panda Crossing","rOUT9c-rFgYC1Eb-HkCJy1_Pdm9PIH2OTxMqnpn4SueGVY2q",71,362,333,695,52.09
"billysoccor2009","NYsNBo9WOTGftAGQwFjOTP6EGe4NBejA1CLjl07LenYlVgX3AR9xTr4vFg",133,287,264,551,52.09
"Hide and Squeak","co2MEn7obOocoml3YIyBlqc4S9du13I8_gVaQxCgMtOk",0,448,412,860,52.09
"ThinkStraight","lLFzjlwpuIQF1D9kH1XfBVN5eR837ZR8vykS47avmennv94",287,187,172,359,52.09
"Nima","eIa6HLbawWyIkHykMU_QmMicg5VyXPrRYie6eswckDv_hz0",209,200,184,384,52.08
"PlsDodgefillJG","XkbBLtpNGtJbZMfv0dCQq7STfRfl-R8p7suRVcJLCnMOlw39",257,163,150,313,52.08
"PimpinAxes","Yx8Nw-WNVDVFhZRyurSn45J-3j0skcLWOlJAZFXVMsSsAN1NJviy14989g",16,363,334,697,52.08
"Xeno Snippy","mU-PyLQcfAsNFC2suwh72H68ycgTRBivpZLx_dsIIqiv8fg",0,100,92,192,52.08
"WINTRADE CHINA","o5bm6Lj4GsOKLr-WZyakIZ-JWr7pnKJVccOKHZW_sk8ssxSe",92,439,404,843,52.08
"LolGunSlinger","Vb5XeQTddae9QnjHiHzMZCfyJQ6xX3RKqELSs4HHfRs-oFk",181,150,138,288,52.08
"Itou Miku","N93llI5NYWMpzhbE13wqSh0nyVezc9tR2UelFdvmn8mFkyI",100,88,81,169,52.07
"Yinaisha","QbVs847mxV5fG7qlkGQEuC9t6uUf_72az0f5IlqixHF7FgHS",75,151,139,290,52.07
"chi la qua khu","TTq_QvRu806H-4Jwp6WB-Y66PrqbKrbVRsv1SE26Zzlo8PQ",111,126,116,242,52.07
"Unknown69","rqGKApFGr1qFgUl1wvGn1bqMm5qKdmSHguZU8GD4rnUJp2c",10,302,278,580,52.07
"9999999969","aG3jaNPzWD3lNtn8cKq5-92jJTn1yyvp-T-a6EmudhHbRjQT",98,605,557,1162,52.07
"Special Kay","YsfGcHSFIChMQ6eGVZSEpBXR41OWqxosr2u4VtnlVUCpCpQ",437,277,255,532,52.07
"NuzziG","IhYNP3QaM59nk0Y4FgaKo2Z6FTXsPrajb299i5kiufZcUF0",243,113,104,217,52.07
"WX Rika19981209","e5qNwabHtIleI-1rHAlsx0g8AaStYxjCPdVFLGzGdms4A08J",326,252,232,484,52.07
"Kioka","i02YEtrcgSAYdoZLVDkardhrBRsIGQfWW5rfFIQ3s8-9gwI",165,101,93,194,52.06
"Łave","146J48WR28wrzptNeNN_rSEy3DSi3C_guG1tIy221MDcb1I",69,139,128,267,52.06
"redstratos","V9G3ySmH72qOTdnV8ju-PmkA2_BTBEyU70Xst1HTjM3J0Xs",317,354,326,680,52.06
"Porchlen","fxUbr9MF0pcxRbnRDF-9N5lV_e1xALfXgJcOWOfWjZE7AfI",43,518,477,995,52.06
"2qx2x2w","3CHNY9_FVzyTpdHYqNvZdo4n_x2s7Edi78XbjWtbXTgrKjs",386,278,256,534,52.06
"LiIaS","c3LbQaQYMp-bafHfklC0ffumAqyYcdMHpXoAnEzZb69W4hY",472,341,314,655,52.06
"huhi","l8EJy8i68kDChpVu324lMi2w49-D4Sxdcf_he3jeazJcWu8",465,216,199,415,52.05
"JsMethod","2FKJCFil81L4rqFPBF7uznLe-qHy-cNxcF_hn-fP5YvvqUY",106,305,281,586,52.05
"Deker","udf_WkDGf8dM2eodrL_7seLkgK-1pp16EFKXDxHV8Taf6CA",76,370,341,711,52.04
"IntSoHardMFSWFM","lT6ZQrgNhDSOGU3Oaws-TzsYHE8oaR7OVi9HGhCtOKeUk1c",0,140,129,269,52.04
"610","ENHVNoJwGowv_Y2YYsiB1j8thRgMqayijzBs337WVHhpKPs2",0,894,824,1718,52.04
"ShepGG","aytnVLMloRISFXiKPBWYPdnBHe9zOEN7Q2WvZmspLxDX9sU",225,319,294,613,52.04
"quę","u3Q-VH6ISc93R5TIEq_4SPr-_qzdXHE-1uhjsH-C13jgPNY",217,153,141,294,52.04
"2sky","gKAGsGDcXUsYlSWDzcw2UPn758OM3JVAakZZjfxyy1-T3b8",439,242,223,465,52.04
"Etheryan","YVy3H-Yj23YvgmFtl7OiqMWt1siAfWiCcx8rbuWMGEUPf_k",244,140,129,269,52.04
"Ashraf","Gj0-F6nHbDlU2YRhpc3YYmsBWWr93sJH1AjW9iPe32zZV2ER",19,396,365,761,52.04
"Wispete","cY_gE1yd62B0ooUsau0ImzE9G5R_Gtw3ud6dykbAdSGdPAg",452,115,106,221,52.04
"ImFMJ","V6NgdfzaMJDJlW8BmGzo-JP8RGw_0qXfUt7-xyTaj-f0x6c",0,179,165,344,52.03
"twtv wtsky","zcm3pNdiJwaVgr6BoyWnG8YsGIL7Nfn5ESzkJgDR5yAdSnibhLmi4kEUvw",162,243,224,467,52.03
"Meszi","nYUlXx2o1xXGKlNH53ynB3I-fcKS_qsSwInoJ0aN0NFzW84",160,141,130,271,52.03
"VÿOppa Fanboy","lcm82Qh7jtFgzhCKhhweZmd24zwyDwBNtTBKZGZUSbRTJyvrR7VfufPGIg",249,423,390,813,52.03
"Astolfunu","QoX1VsFPho47PH8BFDulZoK9mwLGtjM-qFs8vt9ahi0-PaE-XleTrsxymQ",203,231,213,444,52.03
"cinnabunu","nmEIiISCeAdoNyZ-pY4fa8SrleZlDNB_9_fH9ujTk-fno2_Ddi2tPhEJzg",1,283,261,544,52.02
"BestKaaayn","lwIfNwo6RA4V3E8TLUO31mSUBuSZVyUUy79VNdg-_mWnCDKJWBfmrtzqZA",0,348,321,669,52.02
"Raúl","LRMuvO8cXsSp7O0HhycXALJ71B00tUJebL9y_gOMZ2upR5w-",15,103,95,198,52.02
"Omnix","ex3fZcALoswo44EMierNlvddcXPmg8ssjxVg9FQEXfv-yyk",204,347,320,667,52.02
"Salvátion","gIEj--hOHqKqialNruWh4Y_tlpYA25Mi5IOqEpzDHNCwpLOoZ4HvqyicCg",118,389,359,748,52.01
"Webstar","AZ-wXTLM282eDxkEInDhdIKyb6YsWUwcN0sPq_Gp9iKvr8k",54,298,275,573,52.01
"Platypus3","UiB0uce7ik_04VH79m21yFo1klNIKTLw8fSBywldWFsOW5E",333,297,274,571,52.01
"TheEliteJohn","3ZQRicnAiLBruERZE84k9LDeIZAhi4hNXR0wJfh9gE2hJb8",406,479,442,921,52.01
"SunShïne","SCJnQ6qsxgz5WPAIbdJnbj87Zcqy7asT67UVQP2agfewuYJtsdJL39JhYg",237,156,144,300,52.00
"duì bù qi","BF70UQK-JiX8QLJq7n4xPJv-WDW_0hT8MW4tGnj8CH7vN_Q",204,182,168,350,52.00
"Sigma Top","p6uzWaanUoPVYNZm77ltRbCOCbUnEP9pzKz0FuWcFbCt8gI",232,432,399,831,51.99
"RaydelI","w68oMWaxNNH-wHi2DvpqvBelvoUrf7lc4_AjKApBT9R0U-d3",307,352,325,677,51.99
"Teacuppers","9ItQVoZXcEoU1507Ib50oUoPUaXmSbom8S9U4suEXwsWlHw",402,171,158,329,51.98
"DropKickRecords","11aFVPbpjUl3ftU9WBVuL5nfbdMxXwemIduxQcDc2Z5uot8",111,171,158,329,51.98
"My Kûrõmi","gxOd6DWUnJfcU6FzpNWHj7RVp71KuwoYt73G7XKqs2DqXlg",64,118,109,227,51.98
"Folder","As1rOEaCWWOLhyom0N4Lo-GgtW9PMijoe4m0DRsIbo7ryYY",220,406,375,781,51.98
"Bounty","opGIZE6RO1X-DV3Rxh8KSmlqmeRk1cPoQVjr1q0o0qasWFU",309,184,170,354,51.98
"Faltering","g93gaRRBriR228n5DY1TkCOpSqqSJgwZ6DILztlrwLRSi7c",1,92,85,177,51.98
"LingFeng228","9_A9iQZxYbZ_mgcILmoKXlSzWOKIMf7TWNNheg9KZ7Col-Q",24,251,232,483,51.97
"CR Xerath","7TcT-1UNItkwrvCk6LNIECNI7B2HjeX-nDUSL2GLJok0WjI",68,251,232,483,51.97
"Mealź","kCm1GTW7TBna-X0TJDM3QP_6mZCMTygMt-4PYZRreNUBNTc",59,436,403,839,51.97
"icryevrytiem","q_YKbSv0OWx3w3ujq5UCX_4KueEbrOpbBYF7134XaswJJlbtipwKPxdi3Q",107,224,207,431,51.97
"PsychoKinetic","pjehJ0S4TGlXbcWkSPl5I1dAVj6gU_VcWSEPX3Mkp5ERhNk",1,490,453,943,51.96
"autofilled pref","xfz1jMISXp_DmTxhUCuxrwCfKI7uweXxXELW9RlnHckODVno",403,279,258,537,51.96
"Biostir","FPxpFCMM6ehnS3x4YH6Aj7DliXYj3f2omFFXG15WZApyMGqYVo6s5SbCcw",0,146,135,281,51.96
"Enriched","ZTj2zI3tDUfd1rIO8uPwxrLw8Jccv9KfEXcSUhhjdQaEW_k",66,279,258,537,51.96
"first","ezwTyU6ay3wWFfYJlEslywCKtSAwSHAyqnJHr7tDuKKS2p1S",40,146,135,281,51.96
"jkjkjkjkk","eyU0Rear4P8n6kwQbw_ZJSfPWyyhZCCDY9G1VtpEb_ZaX0YH",165,371,343,714,51.96
"Mr Ch41r","OegNf-egv2cI2wjTuSC9ZX1aij0lz5S8wLQVFDbFt1lw7RGQ",0,160,148,308,51.95
"tune out","ERctb6ITzPLATZOISGhXW3rpHZtOxbifME_pHabNL_arj6FWWvV0LSnsEQ",178,359,332,691,51.95
"Klee","oaVILI5yR0QN0AkhojtPpYXa7G5ODqxM2auGJ-1pfCAJQpo",414,173,160,333,51.95
"CuJoMac","pSwd1RQ0cnbudwMY4KYp4WhEBUvPelp5SPAm0QMJocRAQrw",51,120,111,231,51.95
"Höst","75Ao7VxWY_Rjn7P4zWJfQ-fa_4GqLOKOY1f5JCMkj04sLys",52,267,247,514,51.95
"pykespongebob","JAZ0j7ZmNWHQmj9s64VsgJpef6jQxJfJYJvGSppo7MkaK4I",351,374,346,720,51.94
"KatanaInTheHat","C92ladIlIkaMWd3pjpu1RzVdCmgtgbHvxMDiXeCO0wx7fEg",14,872,807,1679,51.94
"Vengenesis","eLu5mak7ZlHsajbrROXhJJ4O1fx5QziQztSO8xFmfCR0dTgb",472,589,545,1134,51.94
"Rexalis","wBhhH4c2ZG-mxJBs6MPxHSvXsh3D4jzCy4k8GIrXC93n5v0",201,134,124,258,51.94
"Hayley Kiyoko","opC0eSHMQRbaCejTeHz08d6pJEG6vI0AQFgDEfCsyjA2lCo",97,147,136,283,51.94
"Draqqy","gm9UUHBKHZJLeS9uZT4kfghH5DjpYYW8V5XLQvQooEaAuX4",193,374,346,720,51.94
"shen xiaoting","Fwm6jEXss_kwoqCYkwYxtr26NyeWHqjS8ACmfi5L2S_HwG8",40,147,136,283,51.94
"Shauna V","r0mgLNwGf7DGJCXXiz6-uVmlBgS3b0E2HK6eWM5xSgwR1OE",30,174,161,335,51.94
"Fidd 1","5eMGX4X_sqm4TO11j155v7aK34kdIpqaFuvnMWDb51ZKj-o",281,174,161,335,51.94
"CookiesforSanta","W4Fsqmm8O3WC2Ln-ekA50RXVeNx-zyAYyrZXkbbqlEYmtMw",395,174,161,335,51.94
"iQ Aashkaash","Ban-LxTWah8N-BxgrY0pf1KSSKmo-Hqm5IOw5oxjthdyWAs",222,174,161,335,51.94
"MrSao","ldgA2L04pE6hTMMMGljM5ZTVKjFeHd2oPamSWc-GcRagX34",208,418,387,805,51.93
"Fullgod","ToBDMwhqq3CgIxDK6amTIMsMEih4fKUreqIITA1GUAbAjEo",0,337,312,649,51.93
"Brion P3Peak88LP","qnXNAGPc84TDy-hW5QNLMX6C55ytlJce2t3V9jkaEUrMbMrE",0,296,274,570,51.93
"Codeine1","RtuSL_jDCsl6t79oo8pYdx0UnpXWWrJQ2Lc1I09LA96iZfsT03m9e7Rc_g",281,121,112,233,51.93
"e girl beater 69","0k0Q_eptphthaLPHVNqQQ2RAcXmbn8kgByg8_zPVe12knOo",223,404,374,778,51.93
"Dobbymon","w1Yu_CWWncAcTusy4QEkH7KqaK1mpOr0tr2fhi4wcWScUbQ",317,350,324,674,51.93
"TVimprovingisfun","oxFTExtVDRHFaBXI7uHJrpc-29T-Qy4IRlg1-SMh_G1nT_MJHa6XQBXerg",392,405,375,780,51.92
"yukito6","P8X4tUJIfuGYGBHJiGlLxMu4DlXbuJfBwfBEQ3bPrzYfAQ4",222,459,425,884,51.92
"MAB5","l-1i3kiCgs8E3fHoC2bgIfDVQ0lhl7Ctt3YJtiAJO19ZHUM60hiGJvpzQA",50,352,326,678,51.92
"Horder","gl42j7lGYc8RMjvzLikpFkCCMArj5T05QrUoKaM_ZLq2spoez2lJTlorJQ",210,216,200,416,51.92
"yuumy top","i25N0VDLmwxi5h3inF4SxSp-YMy0a32iJtrgMWj2H4W_q3eSiybsixXmOw",138,108,100,208,51.92
"yifenglibiexin","TL-S3mpp7j0mBc2_hXSqF6wmOHPtZ9tr50QEHlrfNllW2Fc",7,27,25,52,51.92
"ImbaDreaMeR","E-ivo1L572_nR9q45mviPHOK0FZFsBPIWnOnNE8PslBEpFY",85,149,138,287,51.92
"l Kyu l","PMzFuqec0mjm1EIQfoynNL_bqX1wVDoXXp7YPnngozkT7oo",152,405,375,780,51.92
"Charles Huang","Psl_7DWsKytAFS12_AstZ7cU6cStxZ98hcmTNg3ZIerEj4E",350,203,188,391,51.92
"b0njWa","DVNlTtFDDLMPqbf_3h6Od9NxEVJToJphJtcAXwaRUBnnfeY",271,203,188,391,51.92
"PººP","nLUSlNOHjLHdu-wKyNRW4D5KZHFfbAmujc4FfwqUlMF_ZdQ",204,351,325,676,51.92
"xbbz","FRIALXfJvziMWQbY9HxGv0vuPiCpRCoDgkHkNQzAGjzRIuE",150,177,164,341,51.91
"Javii","neqLLrosBIBfbpjbCldns4lljMIyyj48ls7C1JnjLgGOc6g",250,122,113,235,51.91
"Bruza","v8ot7Cwsqrndg--xMyGER3itJFNVzBR0b2Q_x9z9DaxJ-SOv",97,136,126,262,51.91
"0ne Last Kiss","K0NEN91B9dI8ptmoIEprkhZd6l5vIkTTG9O58Cbm5zjNAHY",16,204,189,393,51.91
"wyxzdwsma","q15NTWnaFj2cejb5alyazeeBjV3OZhg8Qbel8sCimQ8k2DI",1,449,416,865,51.91
"at the bus stop","oqIqIEzA5qZLbCFqoV3oeAjxlzo9G02PzJYEELInlq0HEGnX",27,109,101,210,51.90
"Divinity7857","gBEmUGIurSX_B-i-bGiWMHrfNBpf9i4ODVAob5010-ymOn4",0,341,316,657,51.90
"Geju fanboy","NeRNqyTePUMT7U4TAtOUjEa3pUksjYCkwlshlUdnVIz5RUU",308,109,101,210,51.90
"Mínju","ibc438zij8l6mPv_nH3zl_LNdkVQmxVqATmk0HX7S92mG4Q",434,287,266,553,51.90
"ŒNDs","2N9lBIG-zPHZ5wCXSfrx-xVPZ4UISQNHGVcBZy-G2aflVC8",296,356,330,686,51.90
"FLASH 4 CRABBER","c6Bv3T8eSf65k2-R09590AJCCYAFR5MoAmWDf7r47kSs-38",254,260,241,501,51.90
"Cecile Noir","EGdIZ7cg4VW6qBQHNkpaaFaTaa8kbMNY_isDcOnoJdvhj_U",18,219,203,422,51.90
"Laneless","a-Tr6A51iifISZyArljPvQr0aPIFyQgAHH8Xm6fxmFomnNY",18,232,215,447,51.90
"his backpack","H-DYHE1rclLtubLv3M87wRalR09ZOLmPSPAy6KyKv9S74NuHIWnPxYlFZg",1,233,216,449,51.89
"SUPKING","pFV51woOzIZrplGZBm4A9pX8j3jGTCRBOzTWtEpj6tXbtWFK",78,110,102,212,51.89
"Kills on me plz","PAJDAvoFgUusziwFXQc9iwhQS4Gw3-nOeWZqSLv-3cnvCn4M1Cf-PQ0ppg",438,370,343,713,51.89
"Guybug","XIyabhPig9Di-9ddZyzHF8-tJ-4EsjeHq_qMs8VJBjP_xbY",0,233,216,449,51.89
"Bad A Lil Bit","lKAapYbV8lmAhhi2oYOQAvg0agpgZuWFIUCgaMbdWatF5rHe",42,234,217,451,51.88
"Gold Inferno","tu6D2k4pMP_2uJIG8NJ_CuoSuXxWyZCZ2osL_dNa_obZISY",283,138,128,266,51.88
"Dirty insects","9_vMoNVrjKfchP9lAVhb8FQzL6jV_HbMAcinh7zMIvxfggFH",300,427,396,823,51.88
"1orange","HKf22ovJwsI6sz38CyW4NIQmyjPL7V9JDTLmNz9HMK6Nj18",213,124,115,239,51.88
"Kurian","lz8218uk_XRUVxFA6XemwburV0vNbAYczoLL3tWHatrupgM",112,456,423,879,51.88
"haiseno","nbROFGLLJD3IFMtb0HDrSng6Qq1dT387b0HuudvYTaBWo23lkEQvZCbZCA",110,525,487,1012,51.88
"Shafinator","KhYTdEhPNoEJvFM1aUqD22a13HbjTBH1CUwBAYdGB8eySyw",193,221,205,426,51.88
"For Lalisa","5uYDx48zSJYveEv86GVC2jUzctJH8gWgeZEfErbH9YYZrbw",435,166,154,320,51.88
"Hatsune Miku 05","rZuVrxxEhkXp8jeQVuaqXDLH8SeHr9fX5oq6-25W-4c73X21-qTzWoi8Vw",17,512,475,987,51.87
"lil milk pig","XKPWdforuseI344zHx2L5_gtisl-EFgKU9SHIPDpE9LVTN0q",1,265,246,511,51.86
"KingSamson98","NdO4RiKbBYNW8IDappaCWrgA8fWeHsfQTWZQgykiy85yt-O1y_V3JnL6ww",54,724,672,1396,51.86
"vx15005797715","yHeWlxfroQcK_VSUiRc3jvz-mIuzLq11BJ6PGE4EvwsHgQa5lVasha0xcg",302,265,246,511,51.86
"xue tianshi","bCgO4K8Oht6umuGOnsKWDsfDlMeuFhdq7uMYMbPYknjlU_pG",112,320,297,617,51.86
"Rare lndividual","rBjVBRGERuUVYxoaUP5dNnrwoMDglTdQs527t8Uhef3AN2I",60,334,310,644,51.86
"BlueBasket","rT9Wx6A4Vi2XhH8ZfXtBB_lAmtaNzlhiYqOxO1JXY7ZKBY8",92,459,426,885,51.86
"S 15 6 13","fk5D0QgoDULXVK3nNVYfoJizUEQxw7V1C4gOAQo02_NHPEs",0,153,142,295,51.86
"ikkkk","MhMG5VxKOXpHlL-fyURjuLT89kfWmHtcfl4lJS_pww6j6JQ",40,265,246,511,51.86
"Taiyakie","vNTflZXUNfHf1CrpBgEAezj8B_rCNaJsK2x_KAY15fbGF90",0,251,233,484,51.86
"Ionian Tempest","Qws7feSmtkn1rd9AMYZ2qBx1XCRGEaK4a_phEaknqNJK_3MQ",273,238,221,459,51.85
"RaGooNa","zKMLXx4lZksiXhznQmd18hATQbDVCIpCcfcCDjoxvpan2fo",203,953,885,1838,51.85
"lñl","MFQMK7dWBe45Pu5XrMgyRHK4uN75uyBFnqMXrO7Z6HA2da9D",0,126,117,243,51.85
"Pupperz","TpfrRavo4_N5oRARp2CuCEF-JzYUMFIl73QNCjiCj9x11X4",116,337,313,650,51.85
"Mute N Winprade","Bkn0vbZoF7G5i4noHnefU5KCUhwUSok8JIFlg7yK5O64jGM",1,224,208,432,51.85
"Transfusion","ffapcNb4e6dizz9AlyfSswLfwqQ2wWI-UiBKV1yIHGUbUyiZ",306,309,287,596,51.85
"Suavey","kmRiNKpXYF_4jQ00bTK5rh8dfrCJyvNNuGcv8sknXMSaNs8",166,590,548,1138,51.85
"Fóxx","Ii0Ja0L04FvaMClVECq5Hhitv5Wa2NdiWQNyoOuToW7RfUU",405,295,274,569,51.85
"Dog18763","vBTkKdLy7r_ZgxlSJElTID4F9LTWqVBtCai2xL_W75ON9kQ",64,506,470,976,51.84
"JUG GOD1","0MRj5Ooz5LsZAIaJ8A1fP1FgZPouEF9w7FmNeMqMJ-1buhx8k2o7akQTHQ",223,240,223,463,51.84
"borosx","8FuuNdbH761R-XtJCN1R6vmF2sywCkTaFwzEaoKonVkfmcwcCNGrJ-LggA",434,253,235,488,51.84
"FalconPICK2","jvMV7yizHiNHPdApTjfLbMvj1CjafVcdRQUpmAVvR9b7u18",253,844,784,1628,51.84
"Exultion","8GmgWOvj1UAguYYXApOTgpgVFCiY2ZdHsrliyCawG8bczbE",29,324,301,625,51.84
"55 Open On Bush","PtAX4He4-xw59m44SY7qL9LPOzHSWi6K0HpCUjU9vbP8jIE",1,225,209,434,51.84
"Ima Nut n you","vBYyNMzxUwDyC2-79XqJWenRqg69MVzTc1TAVZgpL--1hrx8",22,169,157,326,51.84
"Hit n Run BIitz","ZNn-TAEsVZ47mET_sOVXBfbtnfg6KxTAc9_1on-U3asIExE",136,156,145,301,51.83
"Encrovian","_CGN4moz5Qw73H2TPtG788m_odxjsJxa7b1cyK6LFucFduk",1,269,250,519,51.83
"The Battle Beast","HUPfP8jb4cNQ8sRmK7vU36XuG5KJwgKua1AILgCeNTuW3yJNFxyIpDjnKQ",207,156,145,301,51.83
"Atti","92uOd7OulSxPAo6dSm535GOzOsqRzuKpC2vxdoRRF06cKvgh",32,439,408,847,51.83
"Sushì xD","ctD7qkQay-NMJLNalG5ma6-mPwJ6UO7l9sW7J3QPYY0mMVM",318,198,184,382,51.83
"Orsaky","86Sf1DzJdeO3BttevApw-BsoM6o54OUBYtr4lxvbb9Jev9gl",93,269,250,519,51.83
"Dræm","1PAJSIep6oNhzuS3dM06awJySktv-eB2tJNh6D2CRTUSWzY",0,227,211,438,51.83
"Ojitos lindos","Cw2ithzNiG0jUeM3oA48cGXWZEhlcICoElWd5MICgZvVuz-FCS8m3u9hNw",87,470,437,907,51.82
"Rope Enjoyer","SzU4SbsxhzjrJwU8vqCKdc45CgPA_e7Z1r_Ki721DUDMuPknU0JmokAVoQ",40,770,716,1486,51.82
"wartrim","ut8BZImpziMboWLd8XZv4Nk4gZmW_sMxlXmC4Sf44gBGJyw",317,342,318,660,51.82
"Jared Fogle Mode","nz_6isnRGY1nYymGJxT36OOXhU27wGLMV66bkfBk6PQMX7ENxsjA32iFCg",373,485,451,936,51.82
"Flornce","YbElXT08OrlpnqVyts-PydlhYcsN4zrajHVFvCCr3_2cOoU",193,171,159,330,51.82
"u n","dMfAurwc8z_CSkeLtO-gY06-MPQWk_yScqs9YYMtUdLxTz6-",317,640,595,1235,51.82
"Fortra","bn37vvjhVZx2PDQl7aA1NIkFGHQU085u2X9XbnQ5kbe3TQk",227,341,317,658,51.82
"31mils","yXYCScWiPkBjZzCpO5SmsToqGPh9r2aJYCbhCKJ9JLXKYAhp",0,86,80,166,51.81
"Lazzaro","wx9Nr-O4HTlY0VQRKQlIdCcFuhv_aCFR4ufTq306RlbD3a4",19,86,80,166,51.81
"Aleakath","oESWMOOE4k95WBLAyyGaEloqugUs_JOJ5uKQaZhAaE9FLes",386,215,200,415,51.81
"Adrian Riven","0Xb9uNKDUFfva-ElSkwHcrux6fxXppE-NsWs-oX16Hy2o4M",359,257,239,496,51.81
"Lycorist","ulL8JrjB3WUV1L58WyyekSGIE4SMJoktY9OtjA_7U2NoNbw",388,200,186,386,51.81
"Shoubee","-M0ai8OcZvs75qiMJ02idpm-u7SdUDs3Tt4sU9L-3FvD0zlCQbBjdqGuKg",39,315,293,608,51.81
"VirusFx","E8SDAgyYn2DvG7PqBEDO92ha9WutOGtbtBkzoUcNN2EaRYQ",73,215,200,415,51.81
"Luó Lì","tQwDnYgunE6_PUifhsqKfwlrljdtFCGeQ8FOy9sP9G3kaFw",1,72,67,139,51.80
"TheTortoiseSonic","g7pzzEy6mwW8x5DsVZsfn01-QwOId2M5VeiR0RGWDcM7uWQ",19,461,429,890,51.80
"Ńova","6NDT304A2cp2S4mU9UsP5_1bwHX5M1ilDb5Pj-hnS3plwd0",0,230,214,444,51.80
"GetOnMommysLeash","F7d-FsKPt8UfMCrsHTrpqz9Kb2TPm2-mzL6jDUx6AWdKUwQ",97,201,187,388,51.80
"yung van","r_cPH_CH64KAT2oOTFdonReIO53MfiWmH3IcaqIvcFOnvJQ",103,304,283,587,51.79
"Ðerive","uyZ8FiHvUqYeT9TwgIoXkxtC-yQtOyv6cYXpWeR63bsRRGo",256,130,121,251,51.79
"Aito","WJ5WLipQg3hYbP0euNvWutIUssI0ghSMxXDCZ9yR0vTloWc",407,607,565,1172,51.79
"Grope","5f3w_W_vBPTwpLasRDW8VBiD1j-YcsWZuRiMmH76TZJqfOGF",362,189,176,365,51.78
"CE Yousef","ZnQKCCMrJmchY_w1X22JzGttpZOVCy-R-BsjgFndj_JjO6Jr1fqVXHG9yg",327,537,500,1037,51.78
"kimo","OPAIcLCPgWe5tHd2FLuUd-6i1USvqFW4nxeowAXY2Lje_oI",100,131,122,253,51.78
"Xeltho","mX7KF8rcD6CnKCJ8zv6Y4oZpB2W75kOn5wCDpiSIv2z44q0",0,349,325,674,51.78
"Koskinen","Rbz0E9CtcGkBQOu0OkoO1epSTNZ8UNXugkWVvnXRa8jrMvg",353,190,177,367,51.77
"Cycc","8Gr4QsP3bYjc3M_DCTPdy-hmQFmx8E4krbu3gDTPfCWuHCc",0,146,136,282,51.77
"GFÞ","fZq0kmOOaVTOdR1-D2zWXakYfnfcX6cV84gl_T-EwV6VGII",368,263,245,508,51.77
"The Peng","vXoFu7GIYZ7kd9V_lHInvVqbYrNia-NK2TQ_2tavP45c6vo",147,307,286,593,51.77
"koujg","PchvhvbOTASG0TkFMuHNMKL2jHeotzrfFZSr1Tzo4YZGVGL-",206,512,477,989,51.77
"Cringe LP Gains","DLcZwNMZ3vgxSjFwKYGvQrpFC-9AvImXUVJSI-_2TGmRjmpu",47,383,357,740,51.76
"El0 Terrorist","41UPKHB-uu-DX1hxoeUXrDZ5uACIf35eMhB3uXrzfg24Gxs",31,191,178,369,51.76
"Gamer GirI","jo2eR-s1UKcs9XyQcUqkIuYqcp5i1udBW_w_VgJ1Zez-I668",247,132,123,255,51.76
"Papa Krab Bizza","gNC16LaNste4eYB0gllH-kxELXJGrlni5ST2r5Dyuljwtdg",104,308,287,595,51.76
"Dueygolf","5V2SkFaFYT9vqCJx3Zr16bnRw_Wfzlvlu9tKlhi71HS_yx0",342,250,233,483,51.76
"Ara Chan","6uRBJ3yx3W-BAyLZdXQ6qVIWhY9yyh-vXItPFtjk0CO1C2-ct3UHtVgcSg",107,339,316,655,51.76
"The saviour","699mGjKiUFUa40VOWekpeabtU1rE8jRfiVL78QyKCocvRcWL",0,147,137,284,51.76
"Lixiannvlyzz3","xv2SvotMiWvqv3FHvkUQ8mfGoksN5KJpa2dQY3pL7H_IW1I",13,132,123,255,51.76
"Schneıder","UsAQnB9Jk9ulYJF0l-L-B_9NQoPf9EKvZ8tscLHdI9N7ixU",312,148,138,286,51.75
"Sensei Spaghet","KPNZ4zbkgUp0iACHB4XdHS3eYFDdUu2xAVmxNAs96S30wTg",251,591,551,1142,51.75
"Lixexe","CLtOWa7s_B-RQYFd-tfaRtbRUQ3WQBX2YGaNM380odLZQnA",0,487,454,941,51.75
"PotatoGod","fmIE3TYFMNWoupmDa8JJ_4tl2LB7YcWhifgJSyzU9bUBnV4",184,222,207,429,51.75
"Kongzhi","mN75u5VwDCIXJT3x66WsojCw1PSRWP2a-wsE7gXy6Y7R2qk",323,311,290,601,51.75
"Chen Xiao Ran","aN2pL3YdGB_KaIdXbN7FZgR09GmVPMRN8ad-LbqDKrs9X4w",111,59,55,114,51.75
"ProphetPoz","W55tZ0Q2ODZGZP_Go_4H1taXKRvohxmGE9qSNEYw0Ik3WM8",9,251,234,485,51.75
"xuanmaikun","Yn5NFwvriWijQvEzdB55PLBhn7zVMEd-mZOB9srDXKxy0_Y",31,283,264,547,51.74
"adc is hard","7dQjHSIlllYW4z9CjBhYvQg3mnai6WgAcF7DB0RcROnxKcE",38,298,278,576,51.74
"Nivy","qkJkkAET8zK7O5p--8OMb8q1dGnNWcGCD8ybJAyI1dTAHJw",110,164,153,317,51.74
"Triops","3bo4wH3DvLDModAe06hY8QwHTeoHB5VkeFohefGtXblBGrM",154,223,208,431,51.74
"ramenpacket","2dyFuCLW8ssoEhr4yAa4p81qI63du2Ggim_6OegcYiXhHtc",124,312,291,603,51.74
"PYKE ENTHUSlAST","YVMMrVK5bhmBBfYiSsRItjPdOZj4HLU623buRa1RoOWeFAs",93,164,153,317,51.74
"OOFAFA","ZwJEikFPJecNGT6GRGkuUYMqhMCGOwyGg5ZzKrLIoT8nTJc",254,464,433,897,51.73
"Le Yuzy","Fjm7k2Z-rzeqtHtflnFGr7Z9aLSd3GRq0-FYocvvJ7Kbr98",2,179,167,346,51.73
"Power Of Friends","SQIpwbjltAbyfErHEZ0oRz_crPnSqJj1BRCMyCoGhvdOX1s",202,210,196,406,51.72
"Herbert Malone","l_5RL1qPavxPi8wjPqKLrGtyeIsxEEzh_XNPe6unjsIz5N4",0,360,336,696,51.72
"im hide","HViwSaLLH4mPhYdYTNDWKRP92qKzhWQvrFA1BANoiZFXpCED",359,226,211,437,51.72
"Patient","89Og2vZvNXwYtIPM2j0f0ByDQMARQqjsOyCyJjsBKRGMxKk",210,271,253,524,51.72
"bleem","fctr9P66llltAqPVhN07S2mFVtnSNuZ3kasule3zG680eEup-iucmjOuFw",0,315,294,609,51.72
"KKECHO","nohUIffzDVat2K7dcgmkn__2w4h6H-srF8PizaVYPYVSsRY",265,753,703,1456,51.72
"charmander yells","jMbz0TV9Q3a-tz_dcoRP2XjE3_3fM13RjGl0d6w6CZvVgn6IYN91sl0FEg",37,166,155,321,51.71
"SilentBlow","n4f1HzJwbcwCnSThW0-lUmqhfTPCwOh87KepdmceVASRFp8",120,454,424,878,51.71
"Pleeko","ACuAOavA8pH46lnhMSkVXEt_RNm-n6RLO5PvGdkjj9XTXLA",1,287,268,555,51.71
"parma jon cheese","9zZiZeg8xyEV0N7dDySVRer8bhj8YNtw6M3xxUMw4ap9Fl8",17,348,325,673,51.71
"mohanno","BwHRNgle5liBsYcidaF_jnaElWvlkjnXdIfPgW32VvmB-Fo",14,151,141,292,51.71
"TaliyahMustafina","9BjDRQWdUD9aykoiOSP8u-BCj_U7kAMoGAcFVpwWNilrSvw",286,272,254,526,51.71
"wenwin","ZNXKmUKJ4WIR4W37w_8SjPd_j7irk6ZJNCWkXjPEpjFgRU-n",260,349,326,675,51.70
"xùe mó liú","XJ0UC-GQvm4qCP6Bmk3EOoOY-GyzN-IWdVPmO4r557lAnGcV",231,137,128,265,51.70
"r 0 l e s w a p","ZtGRNNUjur5ph715Y6bjPCn_x-mRhYMXx7pozBabrAKJCtIdmu4nYFkrvg",163,91,85,176,51.70
"DinosaurChainsaw","VYtSZfq-p2yZsF39PpMZcF41D0JGkcUqT-CbVViaF1rSrRs",1,364,340,704,51.70
"Wastelands","l7Gezs15sMgvviFQYs96_wwhYLq4qgqupV-WnHs70dvBKYD9zjQLs9wjcA",240,364,340,704,51.70
"Waifus","Wv62OTW5H4uHeADkTmbzpE-NBPMQ_nUyW-SFeq8C8Uscuxte",302,198,185,383,51.70
"Yazzz","9oBglfTkCbCAjhcn7-2I5ryvRfIAS7nDApbCTbBi1rGKfyN3",301,198,185,383,51.70
"             Tçº","4It7SLz2tbkaacRIuj42kBukhhXAWSYosoNIfIm-1Bu0gUY",89,198,185,383,51.70
"Where is Osama","QxSfoXStUf1NF7rnG2Y6HFoLXEr1seAfaXol7kwsUUrB2CE",78,152,142,294,51.70
"getrektidiotlmao","AN2hI1qQvYxSpMqbx_Kxh-GgmmYn3JFTj3Z06ryoR_TGzw0",142,367,343,710,51.69
"BillieEilishh","SYFUdJwSVX_y9Q6XksXXUzLkfYJIz3_5zFsXyqijmbUKk24",212,383,358,741,51.69
"FAFSA ABUSERS","wjdI8EMWST4X1WqM5q1JakKFPcyxPf5KCDB0tVe_FqVQ_U8",26,383,358,741,51.69
"Light","BkP2E8jkxJ4mzPdTbEdwlIb1QE3Dy3yCVN871Kjg4h13L6o",400,398,372,770,51.69
"sen la tian sen","Ut5JNWu-37A4PYlGyfU3CJ3DNs03W0_4b_oXDKy8mLlzHRRN",38,244,228,472,51.69
"Auish","4TWOobyKoc-UE_aBNYO5noEaKCHFFiul1ZUU9E7L8xLby4ZJ",362,185,173,358,51.68
"De57","pXYD13VULlqvSefw6gk5T-NoSyHwebexakvK7FjEs2fAnMA",50,77,72,149,51.68
"secretage001","07c6JoERSAC1w9CZCw6yMNuUjfNvNrElLmuxLhcTOKUkAfk",0,293,274,567,51.68
"Tekayah","skf7Tbm-rUrq7BfoqPLummMQi6wNMN49R_dLtdlCbHoumGE",360,293,274,567,51.68
"Xiaodeng","YH-ATYMJS6CDXVjvFizLja5hv0ROGl6FNFO-7MJihDRbEci7",107,185,173,358,51.68
"x z","ur7TEV8NDYPQP69yQHPuUVruPIVkv5BwEtbM87DGQud6qIc",160,170,159,329,51.67
"Wingsofdeath","5J7pl4lxJcKidLlZcrx6OyX8ID1R23YMwyAe84nCHKxj7o8",30,371,347,718,51.67
"XiOnG XiOnG GuAl","FgWIfuZhUS2kk9TYObymi0dsEUpU_1DadRW-HBcvorIB4Ns",277,386,361,747,51.67
"Skt T1 Ker1a","b9yidU7XLa8vD_XveIJdtWxWe0Jq8F04BCHZWherC9W6pb4",282,187,175,362,51.66
"xeragon ","rdIHN9n4T_E544iR2g7KBMJbu87Qs7HVW1z_YR1TfD8DfhRQ",38,218,204,422,51.66
"Linley","R9qXMY2sBbEGAv63wWCkv99nCnWbR93Rk1maCY8Dd2vaJSE",63,202,189,391,51.66
"LOLPROLEGITPLAYE","4k07iYRrDTUfGc4TMFiIhi1SqNAbX4IW717ZYDDXdxHgVxM",293,327,306,633,51.66
"Xiao Dong Gua","_k1R8OY8_P5fhMM59xnZDxv1r64t4fsSzGnIn2yXXr11haY",283,233,218,451,51.66
"Aspen2","XhN4oXvXs83cL5DhOYzeor0jCYWhscdriuIvflQ2ZMRd5sA",261,171,160,331,51.66
"duckking1","a-ABVJ0hYQmm7QfJr2MUh2jl78_lB_Fr3OBiimyYAkjUk0Fq",284,202,189,391,51.66
"NA9 CATBREAKER","OgNZXOXycaQpfgXFjjnrSmB5z6RXdBmC1lr6eeBb7uMjN2I",375,234,219,453,51.66
"JJG","SAuaO-B7ZIyXYCZtlkHj4EYZ0IoYroY3s0gOpud76BiZc4Lo",303,235,220,455,51.65
"miny0ung","hWsGBnCxdsbNSiu72c0BDpHyCNdgsNW6c7S-J4oCfwCxXoI",7,359,336,695,51.65
"IIlIIlIIllIIlIll","pHhDxkuZ7eJH3z-mxFHRlBGSa9b7ZOi9onDSogtTtrvPxM0k",293,329,308,637,51.65
"12 Pouces Mou","vsveRSMzjshnWSzxWjmZF8IbYpnzRlWj_chncYmfv_UpjE8",53,470,440,910,51.65
"Babtown","ltrKjZP6LU8T9hagnt_ryWic3uAmDftm0xOhZA6NJt-Jct8",162,236,221,457,51.64
"Yogurrt RR","aloJubbRwLqUUnLXEwx0fmM5hD2YzRjKFUhXzHdMnR8WVkY",135,267,250,517,51.64
"SpicedKimchi","qua3Fau9svrJRdFw0MucdKCHNk3AJn0zpbtkoXojyEJ2A1E",271,189,177,366,51.64
"DiaoDaJingDuo","Nk188R8moVCDaxFuu3fAINhYkTivrrseNnqcp4glt2uaFyY",315,347,325,672,51.64
"HolyCarrot","oNoWED7oD5GQpleW0SGUo__r-RyEVa9V40tOYqE0wWCo_Ac",1,536,502,1038,51.64
"make you minë","08XeT_isA7CgpgIp1bmNxwegbT1LfXB2Y9TEfIfoeMMnFSVj",201,79,74,153,51.63
"EmuFriend","vqPVcUsuSnTZsESjZxFIiN3KknkB7wvoXRKO8Lb8gFTx8DM",231,158,148,306,51.63
"Beyoutiful","RDTRU633DWf8jspQAGOBYhVLCwH7T5gNBiuBtKB491_mD1o",35,190,178,368,51.63
"I Hate Iran","DA1wzmMG3fPvoiWf4RgmBanQrK4Hi-6Akh-RC2zYjcwCmak",122,651,610,1261,51.63
"Yasukeh","ZNTs_ke3egn-yKrvIrbV8xSAtelR1V1Eq1KYiJshVJgNW6I",425,364,341,705,51.63
"The 25th Justin","aKPBnBadXXj9f8qGDe7VcBi5y9DsbwSXC1oxQiLVvBPX8xM",439,269,252,521,51.63
"buff quinoa pls","q572vlcUmNbyQjEuHGTtALKaS86JkHPdKYxxcqkOWQHHMZs",17,158,148,306,51.63
"X V Z I","c2FMC52DywR5BjZGJzbhHx3mPqx-1kX_oXQ8pt3xNMCA6EXe",136,652,611,1263,51.62
"S2 S2 S2 S2","hPwrFoMlQI5xgBWiVlQJY_xOS9QHKCiQ9_ZQpvFtraAQYKs5",90,255,239,494,51.62
"Brendoe","lMeWnVVQPZQmAZV0bW2hWBN5P4_2c5KeZMjYSCQQVRnG7mw",65,64,60,124,51.61
"decayacc983032","j4rvxb-S8JIthWG6RT2diuQIKVUTTCp0KqBfvyEPv5NdoTE",160,256,240,496,51.61
"is this hell","6x_6u3AqLtZkEhffmBX22qiZxqqMdIIhj8wFdXJ1ieeZvg8",124,80,75,155,51.61
"te dua","OuqlgIIE_nUUcBUslzPp_ycbTaotT8hondZPUGfxOZnDdU0",165,353,331,684,51.61
"Han jae","373IC_ztWDBpQHMf85z7pbMVK9J-xfQER9j8X_85EMywl8o",387,240,225,465,51.61
"NinjaSenpai","FUgb8qwvU6XZmKCD0pu-Xq88nY00gwS8hX4VJPJKSA7QP2Q",115,305,286,591,51.61
"Mudkip71","npKXf9Rnvcwdlsdj2m0sUuqGt539PUCnvsd_w-piAOeBRgE",0,80,75,155,51.61
"Xakutara","tRzArSamxqWj6rqQgVHo5bStEjLQie4XebpLIKldJCq2-p8",50,419,393,812,51.60
"Trisend","Va9-d3AEKrRqeCut8nWlAvOU89OJuK0UMDAQ593wNzURfb_fr3_AvU6Q_A",131,370,347,717,51.60
"ego lol player","K1l8oyBJKyMNUeLfKXwgv1ac7OnZMiu8ZYsgz6Lt_X6OG28",360,386,362,748,51.60
"DemonicBug","Njvauu39gGci3M5_BA3wxN3L0bjvPrFzgJoXE9SjWUfj1m8",456,242,227,469,51.60
"Klss","KKyQ6SYxx8fLtgSG2KsCjgayjDhuHnrVeX1kTXC6gn4iJcU",203,307,288,595,51.60
"THICK N VEINY","TpVEB9e2zb46tCQ2eOv8IjbJv3_goPG0vKNoi3a2tN84wDY",196,937,879,1816,51.60
"8 Pack Olaf","H7_xwmhNBWsY4xAn4y1dNBle-fDG-_PMvGXH_IXi7XrZt2s",373,97,91,188,51.60
"penay","Ovvn0rsQMrWitTaF6GzS9YYBSSIfQ8KVjD3Lsmb4gfGYe_7JJ1sxVRYLtg",1,226,212,438,51.60
"TwTvTuxedoDonut","bCDwCegiavk8V4ytdmk3DrswizO-mtRT5MiixMeHMp_4Q08",59,341,320,661,51.59
"Beckhausy","rYeDHxD4hkEP3YBjfkdU66TUP-2enAG_nqE8Ql3LeEEE_To",149,325,305,630,51.59
"BIossoms","vkWd5VWeeRZ66oELxXCfFwbQxO2JU9sJS1NNOFjWhenrZVY",475,178,167,345,51.59
"My Vicious Girl","Wn9VFXa0xY9sij-x6F-Q-1f9Rp5e3t7ytuOdOJx7HzdxCsgEDNOTXgasAg",127,162,152,314,51.59
"Rat in ª cage","qgHlVYqZs9nRf_OjBZpX1fEF2LOCpdQf0ryqk99ukjbXkh6p",0,180,169,349,51.58
"kikos","vnmvaievRF-e92AK5OSdL-8SHu-Bn5VQBoj8pMBwhRhhs_Q",329,98,92,190,51.58
"S9 Silver Player","hwCjoqoYci2aOUR_MGnNNvNNrWaC2BuIkIPKsIhPZMu-GdQBTP-A4XZV7g",22,294,276,570,51.58
"Naros","7lFmB8-DfhJ_m0GtNc28gvcVuiNLV2vSW54_ILkCGGBZrHEO",222,556,522,1078,51.58
"Call Me Binky","WKMlbcWGzKlTbdn6m31LzuMSBvwVxTs1EamEXVMB-XENi8mX",134,82,77,159,51.57
"Ketamine PcP DMT","MHiDSDaqf0dTt_igDGZo-D4VpXiZEw7s5L4H0yMFOSKVngM",335,459,431,890,51.57
"Ara Ara Waifus","o2AQffgwMdj88ddtBnbc_GZ2oMLpnIEzAgaSTgyS-cEezeI",374,510,479,989,51.57
"pathhhhhhhhh","BmqtDtYDkPed4aXIHzvt3XT-9RHTbI_MM441sckjzaLI9n1p",262,329,309,638,51.57
"kaptur","_FKz5obh-3rwqbxmYNijt950TdKQt0gyfy0NiSd62zlac8g",414,281,264,545,51.56
"Road To Misery","x3T_vxloH3EpRbte_yi-LdOnkAiBK2-alxVN1xhIXEFvJ1U",220,182,171,353,51.56
"ZoyBLS","lVxL7LdSsc4nmezaXUi8KsqHAO2W-lOUoBgHu7NyCFnITacv",1,397,373,770,51.56
"Memento Morı","IPgyHLooN0Rt0BH3Kj6r_Kc6Q7qejzvxuKxdgxwuGgJGigfa",0,298,280,578,51.56
"goatfker5234121","uNRJF0qg4FLuOfgW0uSFjYqGUGeP2nGqnmh9LoMpf1ej55uh",182,149,140,289,51.56
"Hoshigaki","jnUki5nTc1qZ5EeSm8BOKt4ijhiQ6QY9dNTAk1JeO2MJ8h4",346,149,140,289,51.56
"hai 23","TlIUSK8bo3ULHKLecOoOPmSIDGqKjIaMJv4pronwbAK1fOs",142,463,435,898,51.56
"F Hawk1","PYWaAbs2CLBFXfllkoS87ZoEWyOZ6kDRdPkAxYLjkIfYQBA",187,330,310,640,51.56
"TTV Zileanaire","DWQ6-iVAa_uCKQ6v_uYOBNCErjbP25pPTkwKBD4m2MRaDGQ",478,265,249,514,51.56
"Trufflez","8lksbX4-OpmWF5sCLCOIu-TUCWog8ETY7DrPvhccpvcqYpc",106,449,422,871,51.55
"davidfighting","fnDbCJ_o86IkM2MsRjEdw3_chVP_mA6V1dZ1nLKhzXngf98",280,133,125,258,51.55
"LAST PICK PLS","wJuqWeqvCXc5O1bIx-C2vJjxOYAw5bFgn6YnclKoz2h8kHs",158,250,235,485,51.55
"1TruProfit","pP1GW9VmZ56GvxppGuTWGbn9Rdu1WjqyzJzjGnFjAkx26tY",277,216,203,419,51.55
"Gertew","WV01F_0FlqS3KbmIy5yDXyqu2rl198VbNn7IAvldUZJP2hU",16,586,551,1137,51.54
"Shimmer","vlXrHzDHsi76_JMcjuL_uHLcM5aUMvtBYsZp6eSdNZshGCk",339,167,157,324,51.54
"C9 Kyuki","-1vZkuUhBwpWreT6ksrZD2AL5t5zhnEt2tmwMxW-ZwoNrxZIKdS5Z-hnqA",354,268,252,520,51.54
"LĘTHAL PRIDE","lELISANNjN1Pm3JFSlG9eqPfla6x0cHxUfBC0wRlOJhB_cg",41,520,489,1009,51.54
"Jons Jons","SoyeZyfB4LMzrcZnYpRz6Z3nhQS4jgbrEkskTgq3xy0jndc",467,134,126,260,51.54
"Apmud","BBJcyF54pkaS4em5rtYXi2_ZKi3rwsDcv9b8tfApzu_1sik",68,84,79,163,51.53
"H3RALD2","skdlbT5-xf-62FMrDsavPlRDIsftqJsja7JZC2SDYRxbtdHL_iYTuBcxSA",153,219,206,425,51.53
"Apex BlindGoat","KFE-CcSsr6BOc2N8qLFm2a9y6FHdgu2r7L5wbJF6eiubswo",158,252,237,489,51.53
"Wiederum","kHxEyKE27zgQ7bZ74pZV0xY9yZ9Z9VtafQfln_ijGUx3g9Y",115,319,300,619,51.53
"ThePieCrusader","8Nnukjq7fCcObIU9rpF3TLTFB_xlgRa3sC18wrv0q4HW14I",34,84,79,163,51.53
"Anselmo","stm6elgbzoUDg8qR91lpbtWcdiRYO0Ro0sazGD3xwNW1pSo",37,118,111,229,51.53
"Vuod","6k4rdJm72_2m38FqOQ-J-bzJWDe6oAJefPNEiQaL3R994r8",13,135,127,262,51.53
"INTING D4","WDu7agO8jeNQWGbXFyf-3b2hUe5o8Rs0gh0edcOXl0KoiKzWIxpN8IRj8g",1,287,270,557,51.53
"MOOSER","fd4M6HRlCYE-dnOYow7_cjXKKf0nphE1oujgR2_X_6ap1NY",423,270,254,524,51.53
"FallenStarEric","FKw5YdA6thVZrLh3U5oxBbTmfcLV5cW9FS3NPUsSPOlqo4E",38,661,622,1283,51.52
"Bhooki","W5Wbxmi0sfhHGH5ysxhO2yLQicZtEFJpYMlLeOG0NKr14SRWo9HVjbaLaw",48,238,224,462,51.52
"Stop It App","8C6iBAzGaG0RMJoZYwP3D36IWpGiuZ0NHteAfSmEk0gWcuA",193,288,271,559,51.52
"Marquez 1999","5PQdXuBJqzDdx_Dc0NMRxdFdWs-46jqLUIVgTbNpLRq6gYU",125,474,446,920,51.52
"Marcus Falafel","WgV_8z0O9eV0ztr3HxXm0IiY8A0UEv4yoShoZhnlPc2inVA",0,119,112,231,51.52
"MyGunsAreHuge","rWZaw_nppZjO3YQRtu8Lz2QJHgr3NSnp5IK6bJnWRw5_mDk",22,390,367,757,51.52
"Gay Conservative","X8Vp-e86cAp92D0OZNtm2I_BesY1MQy1Spysqot3llX45XzU",83,34,32,66,51.52
"Cpt Jerry","kkuZNMhj4qFlGDIPJkH1XRAHxysWgS39r6-y5s6BhGrDAx3a6hUk565Wmg",57,188,177,365,51.51
"Fierce Frog","Hw_7SF7W4ioHwWQYc87zRcYa3LW4loE4ZapeITpdiVLUjRY",423,494,465,959,51.51
"Qube","lX2R79HYxDtYW8vCiQQCJUICtamxH_HyaiHQi1DaGytdTEU",334,222,209,431,51.51
"lettingo","3R5tKAH3BALJBpy2IWunDaP_VNOSiw7ewS8RhE7_KhYNW1I",17,103,97,200,51.50
"Nicholas White","0hvKTH6X4CiDc0O-kA2CHbgub27w_Zc_yj-VAkXuot76",52,274,258,532,51.50
"digitalotus","SWUBbHM8Dya80ruRhC4xHn1Ng168L9UULFEnkiViMZM_3R0",110,86,81,167,51.50
"Disconnector","hUHoMBqDiPjVthwy8X8aetjHEXaQGsO8U85dKiR4tI2HOVs0",192,86,81,167,51.50
"Akadx","OdkU0yHtvAQAcqbiAKfzeRoyGr_FjgCWQzW-ECsbQq-vbJg",38,103,97,200,51.50
"oddie 69","l4doz8BV_zFOLk7rzfOebAPeiSEHrivyKLYdWiDidCen2Kq2YOFpvySH6Q",88,310,292,602,51.50
"Qukslice","bkx2D1HUEJHWRylhsSgW1Lsci3AJ76Dq01nD4vDzuwbN6m0",355,634,597,1231,51.50
"Enter Me Master","amLwidN8adxpgGFFxZuJwFn8i28MHZhxUmBvGBfPbWFfmk0",0,326,307,633,51.50
"MechanicalReapr","PWCJEICzuw4JLswIqYNjatBr_UQlHkuhvLOPSJTlvZgDs1E",329,137,129,266,51.50
"Passive Top","oj6yMfsPMwW1jBZonR5Ma2KEu6D_tVIk2yrrqGOJPRbq5Es",103,155,146,301,51.50
"Dreamy Bulls","xc4LsopPbhFTjP8PhQugDPpQuXVElolvobmPcllIsLxoPJyYuu8YYsaXdw",274,381,359,740,51.49
"Oblıvıon","Bsk7XVC-BDkUif2eX4wNPEelUfE7K8ojZTrgrovYICsxp5w",405,224,211,435,51.49
"cookiè","0lz4iKJQK9lLO21qEzrIDWnBZGY0ewcW8JLa_g5kcmrp-fs",16,225,212,437,51.49
"Aanzø","E_4yysOui13B7FxiEiSs8QhhJ8pOoLZI7LrxXA5Srs0ShQJP",17,362,341,703,51.49
"RainnsRevenge ","xrmIQYaOrMAQrowQj1foF0BeN5quMUElpn49lqKKunRMjr0",323,174,164,338,51.48
"IceCreamPaintJob","BrrfT20ppMCu_Hf1Mxub_qocnl7AH2uGj7J2UJOmjHrc_qk",393,157,148,305,51.48
"Dog Woo","G9aoA5RnOg5UUln-5bSmJ1E0pF7tRzzt2bqTUXoohD_0aFE",1,418,394,812,51.48
"Dragonminkim","p3LGN1mFCDIQm-FVn5JXT03_YqwE6Gci2VRD4x6AT8QsS1k",402,174,164,338,51.48
"Adan","sI67Kvo1-AFNFzc-nLeuMs4D3KOxbIuGgMtMP3957XQtZBo",345,278,262,540,51.48
"Hexsise","6fVdZiUNf3sCtT3vGxNvDiHsLqoh0ZpfHYe0CI4Whgc38qk",156,87,82,169,51.48
"PessimisticPanda","UVS4a0_GoLUBtg_TLvlH88vwgZTdCpdN75MiIiM_LxrS04g",287,139,131,270,51.48
"LovelyKittyOwO","8yaBLfAFBCHSsFG0U5MNtY67SvwuKWBVIBRPekHTwe2XurE",223,486,458,944,51.48
"bladdee","uj-e0fTf7It1tUHoo2O4mp9WL-sgvCl86hgy4XIJEXrYUi8",29,737,695,1432,51.47
"htag","bJBxB4T3czL_4PcZusbX_anYko64WE0-Wlowt1pWMlaTfPc",210,420,396,816,51.47
"TL Yeon","bIeQq12YYmbhlI8M2lwbubNhbgbYgdcQ00Z3Nwl2W7pZoHOfGykt8A6DtA",83,265,250,515,51.46
"Kato Lee","ZI75Lyz6OAreLXnqcEFYLkAyulbZmoAEVGWet4Dr5sZZkQ8",298,335,316,651,51.46
"FluffyDoom1","rMm05l-rqgSQ6uASDtzXgcz21vSEH7N46qn2d22z-iPnMT8",459,247,233,480,51.46
"Danny Nguyen","_Cvh5Juw43X2Uu9z89LKQO3VfUNQ1NA49OiEhZE0sQMlWBM",196,370,349,719,51.46
"SKT T1 Oppa","6FiMm8rk1etdcfC-_6bocTgi2rPLEGXsxo1AxLagvHryRrQ",116,53,50,103,51.46
"kobý","_3Tpd5fRZySRYfMJOqQ_Em3yLh8ET6PQ2y8HGaPjW5FnoBQ",349,639,603,1242,51.45
"3lliot","E_lqwJPVsJArHZ_BexVxnz4f__Ds6bCVaURGdwLxGSvPZRk",348,711,671,1382,51.45
"tingling","OylKREpdYHoZWi9ohFj2U5_xLH14WEmrUDeemckGLWfnCpE",350,444,419,863,51.45
"EG Draxyr","13JHtRitSaVi8zHv2maV0HjB4dImmfKfue6RqCmNC20QHSw",103,426,402,828,51.45
"3-Sep","vRI1qfl6d5oCZflHyghdamHyxq7jlOV7opBAHlbQW-i-JcRr",60,409,386,795,51.45
"yea lol1","pCorfTYE92HkiIPmc29gdnppb4LZCtxzqSXSXK9QiSFzYGaT",255,89,84,173,51.45
"Sunbeh","QXrF4j_LVS9vysP23LW3QJuxxYPIIj4nB1967Xg3KIBC5BE",360,248,234,482,51.45
"ROPE FAST","t8HFYwhpleNuXrIh53hg31gm12TbbUJp7uB27HpyH7TmvPs",273,178,168,346,51.45
"Finitty City","KkH92BFxuOYlXMEVAakvLKm2475Fqgi2RWW1vQYBwW-zSzg",246,284,268,552,51.45
"JerryCN128","Fckz3bcU8Cz2-dxrLz_lMz2izIKDFvPUsVq6XxLoeKu0pcA",1,393,371,764,51.44
"Dragonovax","t1XIleeuHwztRKO90irblL68ckKbjXG7zksX-9EfNAcLZsc",81,696,657,1353,51.44
"Nillers","bglgZprg5s3o7bJXrwBEhyY9gByw7GMEg4vLhUqdC-Jp4d0",255,107,101,208,51.44
"3in1warrior","zYL45UYFcXWayOmF-MgUI42ic-82VEV50qpF0lhEfKXiyl8",467,162,153,315,51.43
"Fabster","jRkEBMTwcOcegPD6SWxPR7liZ_EMBQSF4Zwpt6dQoXldn5s",99,558,527,1085,51.43
"Sayyy Less","VBl4Z5w9YA7DvupnysbFpmwSNZJ7WuUn1_WzBQ-nRe92_3g",177,234,221,455,51.43
"chizhiyiheng","4tlI2RAGDzjbPrOUJ6p00SgateAdxePcYewhAmE4BNai6kk",52,217,205,422,51.42
"ooseaT","cGyIT3dTLwmS8SDI89xav15NYNrNTFE1Nkmub38xC_83I2B0LWlEHVE16w",228,434,410,844,51.42
"Geumdoongi","IK-Fv1ZrAeduug3yvlXJnYIm-9c5k5fGCVrCOOWHt-pciZmT",45,109,103,212,51.42
"Sangydog","oQJdvLeixaSo5XYQzoYNEqFraBe9uPenjHbxhemZcvGfV2w",26,218,206,424,51.42
"Just Jayy","vEt-myFyrDSQ9khAbiwYS-bIsvIoDUWs4jBSp62kNi1dtJY",28,109,103,212,51.42
"SlyLego","bzPqbvv3EuI8yGU2MiJBbvze8yYswEPU4Ojz3T6eXz9qOZ0",378,254,240,494,51.42
"Piki","mUKgwXEb6N-AqL2_wu5rVCQpMdgJje8asUijofiBiFsgR1I",339,361,341,702,51.42
"back2u","1Leyed-q0EQZ8ljZ8wQfAiDO7YeONYKyW022LahdP5Cf",168,254,240,494,51.42
"SHE DOH LEAVE ME","IqlXS-m7yvc6iPluHdiCHaS-RVfAq4CYJLZNwgjtNRyH8-Y",51,362,342,704,51.42
"Vrael","O1nlTezgCxq1lBa5dlAsGmUvhK4nTvdyR9JrM93w0Yw_gik",1,199,188,387,51.42
"Ionîa Cąlls","wlX2GT1fZ3Pr1KK90eeyX0oYnac8S2ZUJSh1tlYpmGOkeMM",188,146,138,284,51.41
"a little garden","ny89M820ky7a9isyFtgcYwFxiSDz2BRgy2z3yBhWopxlnMs",251,91,86,177,51.41
"FinalWalk","jSJJIRR-ckkXRqwzrfwcQlr2aHhhod9cBfZ870JuwaHTDW0",343,456,431,887,51.41
"CjSphinx","z7Ob8hKrUB9bdJQ6s4ytVjAl0jQ00eFW8x3Xe53zoAJUdiY",341,273,258,531,51.41
"dog td","jV8jGVy6hfFAFFWWwzIQC7q_xXNnOCsK0Ny2i-x1t1BV9Z8",178,164,155,319,51.41
"Boochao","eWJq_evTrEzFRZfoAKVsSiLc8qNsJwdy2tf3Qtgrmj1F9Yo",196,601,568,1169,51.41
"Backin Ratnam","7Uk1wvnbC5GQJULiAdSM-hJYs8i0T2XWEtQZ3yeCPPJ_hss",95,401,379,780,51.41
"er ber ter","y3JrPw8k8cUTAUCEY152jqQhMgFjnrq__0yy-rOEhA7vF_4",96,275,260,535,51.40
"ıIııIııIııIı","0lRya_zA1fp75J6VQFlpxYpms9SE8CILyBeK324agbLGVYA",231,606,573,1179,51.40
"cym1","FTi_S6b9sgziEMNawCVsnTrq8_MpD7a83ywN4raBGjhjZXc",445,147,139,286,51.40
"Frodo Baguettes","WdBerhQMuYmRopsmgNpEvJ3yZPzvtOeDKrAkJbDPCQGkZvA",101,165,156,321,51.40
"Senpai Cheeze","6HB5cjzLOZszknRjYmp_k-_ucRViID2G-H0P2ZIISYo50Jk",153,440,416,856,51.40
"AliceWillPrevail","PdM4CYwhhlMOxXew8IzDlc8rDtypr_9dM_cdNfQlvme9N-o",49,532,503,1035,51.40
"Frxg","lBhh2qg7iIDae7gyopGN0QrQ3cOBgklgf-rvkYy2mGXgGkQ",425,551,521,1072,51.40
"FlippingBurgers1","VCQkWzCqohbGqXcOkUolneECepNJuT0CW6WOFh38vakl0x4",342,294,278,572,51.40
"Angelomaniac","14T03cLzjCZaOneF3EqH_DjKTzvt1qxev1YkHXLKAshlzBw",215,480,454,934,51.39
"Meteodrive","qs85fYVQGrL8Yu-H4iWVISjOPPipgCPwVcGWKu3uCi4dU2c",1,779,737,1516,51.39
"NA WT so much","KoAkCrVfUyCwMA1pnNpJmkdhYNnL5Oz9v9SC-dhP2_GWgi8",7,628,594,1222,51.39
"K3v1nRul3s","7_4f2rcBRciVTl5s1HUSvIOzf19uw3UkSgxFxw_TaAgVT2w",292,259,245,504,51.39
"zxccvxxman","y4J2GPtyrprJEoN9mMOmJryUxfs4hTxja2ec6CVKM5_DQLI",65,185,175,360,51.39
"Mønarca","9tHW98ON3vBP-RwQI-ieJ_EHkZYEkD53ovEH9DV656BH2AmfwgHFqtcAsw",185,388,367,755,51.39
"Conrad7","m8u2xI3SDbcBmq-G_WbjOvHJyCtpxY_M-42kijaaplmd3HI",125,241,228,469,51.39
"wonderboyzc","DpdvFDYDthjxk7OEaD2UTBtk3zByFn9e392otbIVMY8S728",93,130,123,253,51.38
"Jongmanphase","XWIQIbcNiMdyUGhbeIWtsoXWwxmg3U30efcvFg5zOIR-JMA",1,279,264,543,51.38
"Spÿ","gcpnunLl3KYRWdtkFbeGRcah9kyN6VIKh6HrCtDy5fU8nbA",105,242,229,471,51.38
"caivoF","Iw16AMzmowmXhM3EYxFdKcUNFPsnUQDsxL20e4ltJLL_ZKGB",123,372,352,724,51.38
"TR1LL","nXiLLGFwBNWpmqUQ2hwwvLtcI7wl0BoH3T4ChTTtcEhjHAE",394,577,546,1123,51.38
"Nequi","JWDWGH647rKZfey269X7sfajTPRhmxTeVfa1MkLSy6aS71g",15,409,387,796,51.38
"renata abuser","7b4NsbxEIAnHrpr3ZazwyVddBFNaT1sR3W8twA5smRsZIScxIBNd043IeA",16,446,422,868,51.38
"aidenaidenaiden","wRaw1wBnIOxwKdM5K9kY2YK5nMjbD738IWXu0Va4HMzzmkTA",101,261,247,508,51.38
"sticklermeeseek","OXTmYzQ_GhfWvgX5LiBpfTdbDsdOtaSqsDdUohAL1Bihmmo",396,505,478,983,51.37
"Disrespectful","OhWQxvEaswpv9zJRC1e1-oQqK4vbW5awTKqbl6Fnb92WPeA",160,544,515,1059,51.37
"bigfatjuicer","oK31dFBxeRQi-KQHb8rgqHwOm1ePcr-WBc5hsisbPOpylsk",325,262,248,510,51.37
"Substantiate","ycvlw9fRJ8uVpYc5OmYJPywRf7YzszWwT0P5t3fBxkY7wyMW",27,675,639,1314,51.37
"Kasanova","M-6gQpcwsOnGqBGz5Okj7C1JFz6KU6fgbRjFTfng_-W1bPo",67,150,142,292,51.37
"squishing","JIkCvdsZCZE5ivLBMUKXqJAL__XEcTs4FTuVPST-OO6pZVg",18,394,373,767,51.37
"ttv step1v9","QuQtpMoqu7K5NrgDFnh_ROAagjyTh8cZzQxG73tGsdWNcG4",222,131,124,255,51.37
"wistfully","fg9WzoqC1fjZ-KeKsrsr5EQijP3rpBmYfgiJfjKOW7uKALw",134,300,284,584,51.37
"Crassso","kFjcEQ2p16jmiQkwOSAg7UCVYOM9SPj1YrR5leI5tkr5cn4",116,206,195,401,51.37
"Quella","EKxfrkGKZkF5w8HF749c_HmSs8aZWg4eGksCJyM60ziqxYM",108,131,124,255,51.37
"The Real Lemming","4evkJJC8wVuKitVF7MDbRFwNP4AV6mYzfhTEqYlazu_T6tw",0,262,248,510,51.37
"adadad12345","yo-nLrsjBMZqHFns5ppTMZYCjBVNL9fmhoUqRGqtbJuGqzDW_TRTAyoglQ",100,75,71,146,51.37
"Heecher","D-og7qneNF4Hk-nR0t1_PQJJxb0f6qvyWrpzbB5eaXNeQkI",15,189,179,368,51.36
"CaresLess","VYW04nzLHJHMIErVMhhm160TG__1zXP3D10vFieXuU9oEmE",1,170,161,331,51.36
"Davo","3EXTMMZKJOg53sKuwMHmFdnBBX1RPNllgiNVEWH40rQ",324,207,196,403,51.36
"lzidas","vccDcIq-8bwxcnkpjSFsMYC45pHfH_GA75u5kx3UI_1-IW0",86,208,197,405,51.36
"Luvboy","L6XVd-ssUrmHYzrcDUUp3sU-57uDl_x-UVlYEia5YDPVfAZ0",295,209,198,407,51.35
"SadBumblebee","t6VxcXIr2845wAF2FXZjFWmOdafazqKZYN0EtdWfCyvzq8s",472,171,162,333,51.35
"g0rdn","sjIUjj3cJ6ME3LPkfrGjhuZKw3l3mdmLZwmZJzPuWA57C_0",199,419,397,816,51.35
"Hi Am DK","4nooupzERG1eRz3fD44W5I_f-QWiYhOshf3ylr8rFmVHPf0",216,403,382,785,51.34
"YanShaoQingShen","2MIoHsLtY1e9OkwNndrCIk0eDIBA6zjlnFxfndxemd0xybDOkCqsnAHJ5w",122,134,127,261,51.34
"Illuminosity","q2LtIbTaRq_gKsgO4ViTuXyeC2ngYrJDxgzAXNQx1khYntk",72,401,380,781,51.34
"SkellyTheKing","a1C-Br1o4bhOtc1FUN26cqgIyc7zLT4zsSC6J6G3GGkhegA",245,326,309,635,51.34
"flood the earth","IRn8VodIhL-uuGKT0pvtJZwxYJW7RvxxVtHO5guSgex-vaM",83,211,200,411,51.34
"MaSa1","nG6RN0HVQP3er7DzRQD-d0MugluprzXq7IApwy1Wk1ZIo5g",1,58,55,113,51.33
"Reports","GBgz6CLPjkdOxNqFVvMsSbsuFAeVC-IBbBgqQSWxq_MRGZM",458,541,513,1054,51.33
"tyson1","yNgcBlv3rEkYKxkJdnlAi6vlayBzQThJHfS8cxd7fMQVkCE",66,387,367,754,51.33
"Mynameiserk","VsRAqGtO7BWbgq3cHMFIjY1wdKYaMJgdzW1FMZhDmc30DGRjZvrYqhxX2Q",28,581,551,1132,51.33
"luap idranoel","10pZWztHdL76WWursPuZx-vQ7VZbn7G7oJEAS-KbhyBR4d0",199,135,128,263,51.33
"guai bu de","vVnCTvKRZ3LOR7yncCCnuDiXyU_yGmsMdrgyRjRrfoATnSY",20,39,37,76,51.32
"SSJ3GokuTop","AD7B1cOvPaOm8vAQ-HpqQbX5buayOx7DWF181m-6xkh5pFo",45,97,92,189,51.32
"THE SlamJelly ","IFauBlJvWnRl-bkypQhpfnAalztCZ65m4SkCIoYDw_BCu8M",161,234,222,456,51.32
"to see ur smile","AIiHYzjqwFgkk7c-Nf8jN1D1fp7sst5NoPqh3FWSHFxiqHyx",21,175,166,341,51.32
"Zethal","lhz-JjZscZNXVpiRApU1pZ3oxmpWy-Z3JF1aImaLV5oS9xk",468,312,296,608,51.32
"Expected of Me","sRKG9tVSvxiv9ChoeffgzuIPSY8583US-JFvNaSGynkmqxU",67,136,129,265,51.32
"finding win ","oQaZrFJ5u2jwEeoz_ozn_d5K4EKPj7ogb9r8DFXFNvEFAmw",49,523,496,1019,51.32
"Wínter","VwC12oYmbm5-eu1jSXW2B6alz0bClngfEseDWD44sHh-ekI",1,391,371,762,51.31
"AiYangYang","nQIZfcmMfm3J35gCGCmt-vduKlCAw8EMcamBX1YTYzfE_d8",81,333,316,649,51.31
"Emilia","uRHymsGR1fiPNB1V0ID-ekRt484utG5mH37LBBMSzrY_LtE",293,137,130,267,51.31
"FrontLinee","NfQgykjIreJylbomBZ1-8spTznTs8rBSNk1UM8z9RnjQtoIToIjhcU0d2g",505,293,278,571,51.31
"Miikie","UiPXODG9cHabutAagPLMaCVXKt2dgDkhiewv6HcTT9OjAGo",19,176,167,343,51.31
"tserriednich 4","p8GLu-I7g7oc2KRf-LgndxB1mDPNGFWf_xnT6eoUJ_-7JQp8",142,275,261,536,51.31
"I simp 4 Hailey","FY0wvHb_Uf26NRIqySdxUHcBl1w-2m6w5-hqhiraSyWlcGf9gE979q6TtQ",161,352,334,686,51.31
"BLADEROMANCER","M86qS4wYgCq08_FzJVosmgWNQFpxmV9cEIP2omnCqWEUQvFWXb1I51-mNQ",198,354,336,690,51.30
"Professor Nugg","gmskRxQxjtFcOSfxvDIYcNPaCe52hLuHXMbKRdlIz5BBSrw",214,276,262,538,51.30
"Zarathμstra","kY4a4bsIZjB5eC-GjaJH-0UqWxcq32qCbHRSCEJPJ9m-JAs",162,138,131,269,51.30
"Ómmá","y_ythrhIOqCfRsCdRckbzCIcZLfRnXbtwZw37gOKdbJbxQU",261,276,262,538,51.30
"Crybaby Cojones","XX5r4GLEhgIngEjN9K6okTFSYSTZFrnW5-hFqUlc3qHjU9I",123,336,319,655,51.30
"Liu Gong Zi","L5LTuKPgE_lPptVFQXUvhGCLSDYWGODclcV0vDTc81qn3Q8",79,495,470,965,51.30
"Angel 2004","nVjmiKlMI36Pe8Oh12FNDChkEYq1Iu7cWVhFi1weDttEYAPVJjsHV8hcBQ",227,158,150,308,51.30
"demonickong","YTTv6ttfYYXmCBDTE5R_h4XvEuLWDN1bLMlHmrUcSIAWV44",131,653,620,1273,51.30
"WhatsInItForMe","cxJXiSFdOqePP_XmSiMDpsu6zM56p7fl5DlRvIXST4ZMHX0H",122,177,168,345,51.30
"b sMooTh x ","QnZFz1wj-AHeBMWefMfL7tzfweU4iNp9rX3L87ZiFkpWYY4",430,297,282,579,51.30
"DbolDENO","l-dioXHsNidiDXzaLQx-5hc4DPMQugl5tyVclcQnOCVifYM",127,199,189,388,51.29
"markboots","u3fetsPQYjPwPYVfVxu572FM1VjFBahKRwpXPEUsa8J8xCs",140,278,264,542,51.29
"jordycowlover","v40J6QAISOurMhVsosg0lT1F269EKvhydnvDC0jhoIm1TlFXyveLR87Dmg",145,598,568,1166,51.29
"Paris in de rain","Du94UrsKkA0LkYfmeizjJEOG23su58dHblnj2nuROFGfiA-a",187,278,264,542,51.29
"brownpeanuts","VE-mRrSf5yhcAQso_v_LMH4piozjWnT6fRNR9gH_l7lZJIA",108,456,433,889,51.29
"ThereTheirThe","fe-hlghyOCXDxVsbrxeYDGQ8YFU6zVE4b7qeMoziuVaLTQQm",34,239,227,466,51.29
"FyGameAwn","lKNmkfCPQlOKuUObj1f5nvY4od9m6iYWPv2oUoKF5VGHkv8",154,457,434,891,51.29
"stinkyfinger721","d-vzrEgTCAOmsH7GfQztDmf1Tca6Qz6MEfUoUkQcrqsrou8",429,179,170,349,51.29
"Shweeb","GSAwMz1-tmr16htKwMOi9JJ_1wgR3nhmg-R64F0OBAOSb5Q",383,318,302,620,51.29
"Lilsquears","PdBnHcQAPl9nVOgVDXrMadAm6lGq_dQf2eU1VuVgx8-rxohg",33,261,248,509,51.28
"Puyikes","Rf7satTPlgg8VzRrNeVJs_2SZFZdt7oe4IXFum5lUV_I1QU",307,241,229,470,51.28
"Wondo","NFddtYrTrho-kr6v56dDqgJx8owTWlAFKvvda96WJThIr4g",237,241,229,470,51.28
"Komari","DTprk7I72xC_UAY7Xen2W0uZNhuKRpW2UI29VDd_ecIoMw8",301,401,381,782,51.28
"Nishimiya Yuzuru","xRSh9wB1Mfe0zRvBzrisfR2Qf08bmQ9gLXZXnKIG_tlr6ac5",10,100,95,195,51.28
"CitySushi33","zz5ZfsdHUWsUfo2V-mQzD7OGtGf26e4lRBx8KitwL1RQ1QQ",43,260,247,507,51.28
"ëuu","03xnPOgEFHFijT7cIN38MlTjQh0M4O_0prO5tu25NyvC5jg",14,580,551,1131,51.28
"Mixtoour","cOg6WPC2WlQZgAeHWRw01Eb-N5J8DNyczBw4CTJ2aPi0R1U",444,561,533,1094,51.28
"ehyeh jireh","RETCl9e5-Qel4KxirDdSp3NNnkOWxxNDOD9FfwaOspH1reM",188,81,77,158,51.27
"BB man","LoNwLbjFFvsT3JPpcNQ53t1J6FIH7A8FN0mumt3fLO9r-Z84cBmPlf-CPA",26,606,576,1182,51.27
"Wofye","TSonDICNEl3xAkrLWSbn6cfU2fMAo7Oy77R_2LV-B-5H1hc",407,444,422,866,51.27
"Sonny2o9","yi2-u4MK3E2gggQkZsXNhLAgyVU_vAyRzUw8If-smRoRBA0",268,202,192,394,51.27
"Aosuke","WMTlGoRr_FhO4jLcrWW-bmZfvtPu8jDfxIY711apvcJqnKUU",29,322,306,628,51.27
"iDigUrGranny","xvCtw6KpIxX5ugjEwFxEB3-SB0K_VynaWICUJhK-Q0dMwt8",87,567,539,1106,51.27
"Conveying","JjUyZAhA_XdSg-_7ja6ADMfPd3Hhzm6emDWgeYOZ2fs4tHvD",108,405,385,790,51.27
"engy","Ak8J1sv4gfQz-o-llo_XEpJf7dVLHFnjJO47RQ9_6HX64Xg",254,345,328,673,51.26
"A Slave","iPn58rNdU7De-qOMkdHxNb7U7z70oJP5qaneyoZ5ve3M0WJp",138,449,427,876,51.26
"FlowerPrince","WX1exGgk8Ua7jXtwN1A_JoooK0Zu_YEE7CYWB-mV94GZiF8",268,689,655,1344,51.26
"DTC Peter","C9MZl6-fY4znzB4rdKgLUYP5zTc1o9wJJ23qhTSDA2NUoqY",1,82,78,160,51.25
"drykfce","g9OH1MB0LnNKCzb2LQN6G5NKW4p3J2gAiW09yGzKP7dLBy1ESVMLsJCDFA",0,327,311,638,51.25
"CoIby","1PA0c2_HxNAOM1GXvjM8YYJUq9W8BL97Dg-DE8rneb-WEY8",159,290,276,566,51.24
"TOJl FUSHIGURO","5Wclo63bJK1kDdDyYw8W0chCHK6bIgX2Zm6NzGXFczEd0aQ",433,311,296,607,51.24
"kyledog128","Z8uz1dtaYPeM5wNaH5dzGWExaHvFhMke5YLiT547256Aklw",0,641,610,1251,51.24
"CR Min","RRyIKQcMZRdYbzswl2Xylc8WRvjHKqt2hT77M_qxxEN4M9c",380,208,198,406,51.23
"Settlement","snXG5U90NIe-tCJat-avXiF_HU13wbU8C1yETyaZm57L3Uw",174,418,398,816,51.23
"Vlądimir Putin","Li1OlI4PRTIMWpFLVTcGyyCubzeOJBVjjqiJW0Pcb6I_u5Fz",159,332,316,648,51.23
"Split Moon","wQzOsojVJWAM1jA6q-KJRZe8SwITxRIqREDMbnTd0PgrBffqgr2CbNhTTA",247,398,379,777,51.22
"Gordeza","lKve6caFDcIcY9W-WQih0BPATlyos_MFdpuxRjbjC39vLpg",272,147,140,287,51.22
"Pr0C00kieL0v3r","FRPX9AU5I5-uHkNgd_GudXuhc1BOhtF99zfkGDDChecsAJw",99,377,359,736,51.22
"Dragoxx","yIXLu9ma-MDOOf0J_RHKjcKPfZClWteI2XIvycBMoLdTyEs",214,210,200,410,51.22
"LTQ Kwan","I-5G3C5rIlgGzyuAlBnunz6v6Ji3SusJl6hSCBmljBQy97M",1,357,340,697,51.22
"FeedLaneGetCaryd","dWieYrlHTIkYRcCBp40zIsjOoE0kTc91ipNRDx8kCVECVkw",198,189,180,369,51.22
"Izuyui","wAHJyS9yOq1VLQy6YGlbbslinTVGnTbZSk3q8XIxAbzNbjl21iGMT4aw0A",108,63,60,123,51.22
"Dooopy","ef56XhmU84QoWQ-2BqozLtz3gNDoz9ZM7dv80jomCyGMWx0",254,529,504,1033,51.21
"Student loans","YTjU05PppYiFSW4ak5c77J4Rz96HhnyZDetQ8LmLuyliDZ8",169,361,344,705,51.21
"Hot and Gay","Qs1dnLvgq3kHEtHtSxnXVosviY3v5A-9oyi_-ZiLUH1t28E",161,530,505,1035,51.21
"PopFizziez","4LH8U7b8a_pW9M--U8zhmxN9ErWJVxBSP7GDqKgTsjvlgPg",185,488,465,953,51.21
"dTian","3-MckKzQ8TdVtr5KtwN6x7G3AQ9GRsvTF2rqrbuRzk079Us",291,339,323,662,51.21
"Zeralancer","esoGKr5WYeQ6sxszPR8iAy_NW8RB-LSb-eVbrHpxsijh3fI",93,743,708,1451,51.21
"NanChangDeityE","QoUiCZ1D-RMKCno5HcNvWgqgSh8kH3daFvOP4JT_w5UNvkY",138,385,367,752,51.20
"shiro1","R8hAyVvIptoFQ4wqYuKML-tXYS2Vpcr4RTzdZYxwPdRF6qQ",199,170,162,332,51.20
"You are My Blue","bSPI7HkCFrrY-MwDhvWHPQ08qYwLtJ6YcN8ugrPRBIponfc",380,149,142,291,51.20
"Chew Tops Yew","tjITMf48Pc0UgRXiLxtLh3Ycym_erKFNQg2wvEGDkPJ7W_I",171,532,507,1039,51.20
"Eästguy","vewjQW1r1Gi5Bqk34S8YQ8ihqtu377SVn16iLN1DrvWuxjk",390,213,203,416,51.20
"Noctal","WbHCE3d4zX7_ZbsC4nymmdi6OVP5eboo4-Q51-nnBBYtr9c",65,321,306,627,51.20
"Justice Punch","gddZ0ZE71FSnD58k0r82juFG9MHFg5Cnr6-2wrwuW_wYaWk",292,938,894,1832,51.20
"Calysta","1GmDe7rTgbc_Gahsm3KAwWRXi6b97FOs6hXecu71r-0tNhUN",0,64,61,125,51.20
"CC Pengu","rSNUJgQismDApHbAVFDc1kJgjpB4IKIB5yyfSpjmmHq1kRU",293,194,185,379,51.19
"Morbius On DVD","O0bJqOyV8plYSKYqiA82gUnNCBwNlistqXlAzfxwrHaKdaY",277,301,287,588,51.19
"eryf","wxTDUpE0KhlqY5bgsw4cL1CCtKHZx_weOXUrkfv9HH1uS2YrGWBZw35HCA",37,194,185,379,51.19
"kersey","U45rBbHT3BZ6yGwTqpWmPs0ospVriPhspftywRDHc2sH7yNi",98,150,143,293,51.19
"InfiniteAim","L9gYC9c7Z-pI2VbiJ1sglbkiA4670U4S7Nkpse1tMSoANIY",269,151,144,295,51.19
"AlphaChadJungle","FGVGZ20JQbz78WPgguID879Aw8qQbhQf5J9dAAWCk69LsTI",16,344,328,672,51.19
"Jankosmygod","BOnFXqAoQboIxrWgZ1yR_APsvEffylsTOYVrWn2QHWmb6hhJ",158,367,350,717,51.19
"Sentrill","fTPQxgLrDEQydNGFKoJ4fTw9Ss3VsrLPXlsgpruE_sbz2hM",0,540,515,1055,51.18
"NinjaAqua","QZ9yn_KZckrKPQkJdiQaC61LmFF5yLQI2S2oAoiNl2Ik9K8",202,65,62,127,51.18
"4113n","jRrmlnYz012TF07SvedzZX_bx8GmE12tbZ7OFpWO8ntcgXo",283,173,165,338,51.18
"Sounds Good","BZloPm8_juwqtwm-R6HcUUQSPdrdmo_tSN4C3GZKlGBu2Gw",204,87,83,170,51.18
"Nidalee or Afk","t0rV8SYgrL8OeFEUm1GTLe_muVAyzjMKNPltxyKvVXym4L0",325,217,207,424,51.18
"wolfie is","Gu451o77-eyDMeiBzX8dtSHpZYObM81tKWgspQN2op5OVKU",287,390,372,762,51.18
"ghelb","ECce6YEQK7s-Za_hv-ogCFkcsYTcwVypQxWpPS9eJMF_QMQ",0,675,644,1319,51.18
"Shadula","lfCRRNBW19CJKOp_ianfVSIQLVIp7m9bdbyu_Mj6gnZUf-M",98,347,331,678,51.18
"Soju","zGesoUCcPCbBtMx80XadKFU9zE2aCS_DBrrlT11GuMv0aPA",394,304,290,594,51.18
"Mute And Pray","i_GlSXvwcN9wHmk_vk8Usckwbz3SLIKwTW2QD4o5kMTk-94",388,760,725,1485,51.18
"PAW Patrol Lover","1B8-B7mg_D7E-3NXiTDlnBYt8jVcv7nrQ7SiiX-C0d0uDlP4",0,328,313,641,51.17
"buhaowan","NUs1cU-IlouNWQNDFrEkNxq4PHIH5V0g5OYAUpg8Pet-VCBD",67,131,125,256,51.17
"Niram Awagatik","5E7r17xNieF87-x0H3BEFXGTWMj2DPjLy9O0K3XpXSv8y2Ww",223,305,291,596,51.17
"Sentrial","PRygsc8OTYpAMR0hUHVgQsc4-qdt_7QQ1SeXE0Af_k9Xjps",272,436,416,852,51.17
"an lian","3znmKzC3lW8t5KwSq_o6dhGkvS7HmsFuTwlIWuXCjuC3brG07yvIvMEPeQ",172,176,168,344,51.16
"Number2Ginger","UbM4hJYMrgl7AZMDesgQqgew9BWjLmlAJGOgqb6wUfgv-Ho",130,330,315,645,51.16
"muting all npc","wrPE9_j1KRFdBZ82ySxH3qjZ2Wfwtzkbd2Rqo9uMfAdWi1k",398,332,317,649,51.16
"SkillHard","P590vV_HlXVgh4b6uzaKxNnjH50yovmaZDKNcg4PU_pQ7x0",50,464,443,907,51.16
"Hey Man You Own","jSzlwuBXo0DhVBmTH_FrBNoWPPxcmzHCxSDfZxvyS5yLsC0",281,396,378,774,51.16
"Jraff","RcBXs49YPpE0WownnZcsn8Ga51-bAe7dEN-okLJ_RNmjSR8",236,265,253,518,51.16
"kanonbob123","-C1a_QtgI_nJqPG_qIV9HWGk67kPBpixO8OSORVlhTOuDUU",267,374,357,731,51.16
"AiamDaniel","pFEEC-RjSTQ6Z9WZtwOizwC8Mk8jcfr-2sfHRJNvu_mv9Psf",118,398,380,778,51.16
"Wallah Reformed","ZCLtBcG5mP2vpCegqIsuNclfq6eyA2nOT1xE059AVeziXHvmIGCDWpOiQg",43,491,469,960,51.15
"KennyMasterLin","56cl-an3Zg7SnYVb9wyTVxMiiWHXQ0OCXUURZiggWuDRiwA",320,134,128,262,51.15
"Yasay","vOr0FwwJKnaYrr5boe9xZUGJ57BaGuq1UlnJjj3xw7qBCSY",77,776,741,1517,51.15
"TwTv TheRealRTO","7BndRkI-Q5w2NtkC-Ffl-2DoJ8jbYDYydhd6DpQP1D1Ihwg",165,667,637,1304,51.15
"Stefke SrKn","so1Ijrj8xsBsGWHoL6lLTZmxhgSiV4raeVOmMyIDcz4rK-5vlVYdjeTjYw",186,267,255,522,51.15
"YellowBumbleBee","Y3ZUPY3HYzDL1c2Sp-ENCsUOA1tRsK-Rg22esMIvRLhxNUk",190,314,300,614,51.14
"season 11 crummy","MlIOf-K2u3ZzoUJoX2oxLvcnexP9BouhssfgHsFasa1uPdCf7we7F0dEQA",114,359,343,702,51.14
"marcellui","zt138xlXzzP29bZ7-7B5CjjdKlbStnqPxgAXlZe6fFDg6E0",59,1006,961,1967,51.14
"Ebi Mayo","beo25CjkzyVrE5XupDuMKKd3Ebwvo9FFfQGfDmOKA6C5UQU",154,112,107,219,51.14
"send rope","vw3OatAGg-NfdRLvnF_PQaDU13uHkgKMJxg5jzMyCkBKn6FD",388,271,259,530,51.13
"1Alchemist","mJFIDRpuU91v61hJFsUtn3eMv6R1qu3BphgLGb2bnxRAyac",390,406,388,794,51.13
"Will Type","4f9PAA2mqoj-5tuZi5eA-QUho8G9ECs_Pfv4-B60ReNbBvU",418,318,304,622,51.13
"Mojo Jojo","UJqSFPouL0sOuvMYi_74xl_yn6HwtXrW59uLpsqMmQogZj5v",24,204,195,399,51.13
"fairy girl","JXPURi4Lxxtsj27n8FaaO_SPtkg5DSgI0PBiA0qDyYZKvms",413,248,237,485,51.13
"Tzupa","0Rl9sPnukH31LbYVvADE7AcUmy-FM68OLIj_4mjJIMpUpvU",1,407,389,796,51.13
"Fonty","lzq1JHIzc5gV_U0dH6jQML9qbv_zPJ__N6PkUoG-RncfO88",185,317,303,620,51.13
"wo shi chongtu","K69XZTbSq8VZeEMgXVJ4XtfdGG-FTerNJivRAqwys3xHYVM",419,251,240,491,51.12
"Expelles","sViF8qwptomzvNhjVyqxkN5fbIYyBZkVVKf2wD5APKbk0vU",18,342,327,669,51.12
"coint","f2_j7IPeNOsEn9jBf35x-bRzn_3EBAkEMz9_IOlPV0CJPw0",126,206,197,403,51.12
"Booby Trap","uSq7Fxew3X_b6pgn1TmvhPvHSZ-3CnZqW-2ioidP59wImJU",400,458,438,896,51.12
"Foxlooo","kX0sZfkVa1k3q269kc99Qj9MgJb-xclen17rHFrycuIiiMI",218,137,131,268,51.12
"Zenìth","L5h5LeHaZBYn7Cv9PSaZZ2-EZGuFPheleaLyVDhDGj9QRlY",42,114,109,223,51.12
"Boombibi","a6y703zJrU70gSibm-Jg1m9eSYhmg1AjtTfWQZpAKR6sd4A",229,274,262,536,51.12
"Fli","EOkuw3d80bHrKPWF5ceB2U4ZZqVZNsJu-GLpQ8b4-Ae75Ew",254,364,348,712,51.12
"Kevy C","zpF1rjDmV00UXCQp0nahHs_PdT_2wUqo4m2krA6DHEJ27oE",339,480,459,939,51.12
"Newer Gas Prices","MhgDCQ97RZtiSoNmqCK4FQImtYpxljzYAIHXmyu5FH3lnxQ",148,320,306,626,51.12
"Epi Owner","dZ50CmertM6RyLUf77ThjBEVXq8hNk_zuJQUtIXEMxdEupo",386,254,243,497,51.11
"slickboy69","37WnKyvtaD5PxkHGiaYaMrq3SDAeeF2Wjy7PXpqOuoVzeOo4",41,184,176,360,51.11
"2020 wasted","jZ0zPkFSq_EuoIF1XTNjZlLTKr94C288DpMnJSI9r1j_EMs",27,92,88,180,51.11
"TTea","UuIcy0HZScgBd2fHTNAUQxkYuBE-7C9M3z6Mp-OctGeHNGA",422,299,286,585,51.11
"Gandhi G","iEI5nvZLAyeumzRmqTlS38m4HfxR6Nur1gZli193Pve_EwU",241,344,329,673,51.11
"zhe bu he Ii","NyWDQhRZ2AcWv410udA_h9uopXrBtaHdBJVG5ioHH0skj-g",342,323,309,632,51.11
"uncle jamal","3IYGzGcctOZWbqa7RSuXYGdIPUAmYUKd8ozBoxGUCPqE39E",421,208,199,407,51.11
"Not TMoney","lH8l3JM27Q62qmSOuZMcX_6ZlMkCc9UVziZvcP2hG_Ehe28",219,184,176,360,51.11
"Fang Bei Juju","M4bFCboXOeweLT8BN10b90hHgUCMVMEfSGWyvYxmYUm1vtU",465,300,287,587,51.11
"KillaAtilla","kDD9gpWzfF5iZxTJlkPPVELItBUW_uuOk8kPZVZcCCh_oBo",1,231,221,452,51.11
"Scotch Game","X3rSqCjnKzjqidyUPNM9S3h0QQZts3IExU-70zk-eCwRuwM",245,863,826,1689,51.10
"Heize","sxP0ejA-IIrp4-bdEO1GGlTcmtlPvqkuXiiwd99LND4fVm8",237,186,178,364,51.10
"Infextionz","4MoZ7RWHasFg1dTPhYIvtEj5HJ-2ZPFu5XlfznfKKKjaqLE",136,140,134,274,51.09
"Chilsung","xQvP7T41nQhP7M839KIh8mHsO_hkiFK8CyMjedJs8e649Lo",58,117,112,229,51.09
"mabygoodjug","HMNTNxt4dn-d4cadPGAaB5jd1s68w_D7NyqkSCA4vhD5n3w",257,188,180,368,51.09
"Veintiuno","6doP7lima01YSg_Q52yRNSCKVX089hlZV-iaw2Q1apS3m84CiB9P1M9bXQ",192,281,269,550,51.09
"ABYSS WATCHER2","0ZTHFHxWFk8vm1Jz8DXbu412DlpRF37n3sON8h1KlZz5Rnf7z-cw35kjrg",374,797,763,1560,51.09
"wananzoe","TeK4oMOONeGRIz0sJzjcKnz8r5m4Xm5JJ9rbJa0Zf0VKE1o",201,397,380,777,51.09
"DaPointGuard","C_RdcEvxb11wWQl06bQKH08hnco-6JQqsI1Rru8eQ_PKSuE",446,521,499,1020,51.08
"2085 Dr Tran","gBO7_iGa0zCDAzsxFkg72Rkr-0Yf1nX0i1z8a11vjAJ9ET1q",180,95,91,186,51.08
"grevvzs","MPwuXtt6MhEODFSmHn4rvQBuR9yzInSD957EyOeWFeuBapo2aTvjUAbiFA",250,542,519,1061,51.08
"CapitaineMinou","Gho5pyc_56IMGwUAXjj-lXJCydTmBPzm_7b7WMWQN-m0W98",234,451,432,883,51.08
"Smell Like Tape","xdF6g4HSjeeDajhvdfs1bZFu6LAIb40iEFCC-7K8n8zCOdg",127,95,91,186,51.08
"asap nocky","OzqkTaFhBf0he4XgFW-HtuuhQZ6x1WqlVt83geaMllEvuD7Z",442,286,274,560,51.07
"iikk5","ulxUzOWTePoqpkhllDIbgaIKka_2w3uDtgG5evd1Qz3rb0Sy",83,644,617,1261,51.07
"Varihime","HSlDgHwej7muz-Fol5X6SHcdlUB01vFZ96XnT6mdeHU-U1Y",84,119,114,233,51.07
"Kindredgarten","irIdntF-KyFbGlpmlmuzgKbOLUmssHaTF-kZEl_JqGguf0M",124,741,710,1451,51.07
"Dreamy Zed","oxG8aF1-SF3K6uedD-wX1iBes3zU0C79uBwvsoSe3Tw13eYasU2LyJkJNg",142,337,323,660,51.06
"Nausicääa","lZ4fBXePMFYekam3KNEf11RiwbhpueFSA9u0XIr59iLCTGO3DU5UF_EHCA",121,289,277,566,51.06
"SkyStarZ","p5rS7uVd22LaWa0dZwlLvlpJHf0RgsEnMLgLb-berW7vnqY",40,336,322,658,51.06
"Masterfiend","71XN9yzeKngFDHPmqFvo2ul-dZVBkQWNRt_PzwlsSDpj6Eo",388,532,510,1042,51.06
"miller68","JbaEmYL511fej1__cKT5mfExGhUcoU_c9o0JyHIsyhBAH4I",125,241,231,472,51.06
"wifebeater34","Ko7ZKLREpp5VZiAaZdcYvxqN1it8RNKHWSr1P0T9q1WGa68",281,169,162,331,51.06
"A Furious Doctor","NaxRYIriVwaXZr4aWBy2aiW_tjD_be98xARX2eO1a5OIutc",118,244,234,478,51.05
"mayrusharts","EoI66ixMsMWnarUZNJgT-J2d1VKkN5ANmc0fTraEZgCNdTk",160,146,140,286,51.05
"A Novice","f8WfANlzusSnTyIJ3uOMa2CwrxMazzoZQnyMHjRxWArfaoBT",320,243,233,476,51.05
"PointyJabs","S5AmR9-fKgm9tNBdk8AIXjmD0ubHJQoMnmZscFZdm8SzrvE",270,460,441,901,51.05
"Ahjistair","ySg6ArXEPeM7dTXtY_jKivcEUggi1j18PtQYpqpsMXYSqDE",65,170,163,333,51.05
"Gmandlife","psaTu5n6ACUvIAzZmJisIgua9rfy85Bq3QqIBPUqAvgWpp4",361,195,187,382,51.05
"Yoshiey","qJnMcGMcMf-CIaPNZkyUg6nT-9SqS-ZZ3jigB08FyWQ_aXI",201,293,281,574,51.05
"Fiorasfiora","a2Y6-K8tWxEcXMGvU9xLei878Giuv1rIGzEF7bDCVBaFxr3I",251,559,536,1095,51.05
"Nickji 18","pIYDZVmI2Xmjnpl7nIqu3rGryef1IquHZ6UTkPGLiZtDp8w",97,194,186,380,51.05
"League4HOes","848M1_ok-p72H_c6eS4nt5c_3oM3duL6ln5shj9TmmIUFWQ",216,291,279,570,51.05
"Scral","cRrcchAQQ8f62RZjNFUd62EPYTYWpXDfyuW9-YeaIMB4rj8",112,538,516,1054,51.04
"07 13 2003","X1HYn66EZKUp6NAHPf0WrzfApLTQt-soXdd_O6-RKd1xusQ",332,490,470,960,51.04
"My Dream LCS","jmYd87hd6G9Q3TeVKLLxT92kIrIv_nikmjqV0V-fQs3bw8OuPfgBnEl6Fg",140,49,47,96,51.04
"Raeghal","YFu8M0qXUH7J0qqNwWwROfvSKapq-IxyKpC6hqA_xSG22Ys",33,172,165,337,51.04
"GnawMe","KLuQBOyR7qTqSnmwN0R9e8hhDhx9Ej7QtTuamECDicMUZn8",125,367,352,719,51.04
"Limerencé","pKB2xWx0tXu14RP75aGs0vvblWVLGa6YlgCW5YglXH932QI",100,660,633,1293,51.04
"Ruzuzu","9cbzchiCffFSr0OEHcXz521lrew4M1m9rkwehbd5SR4bX_E",16,344,330,674,51.04
"No Role Models","4Bu80hvFtQjaSP-Ex9wjFRsFVw_9Qs78gp_2S6C3uwCL1Z4",77,197,189,386,51.04
"wushugeheiye","rkkTyog5qQYpsrFJo-B2QW4nfdewUxStAeBLqMVtu4ZdlGKpmn9xqlDweg",229,468,449,917,51.04
"Main Sup","C6XwpxBVooNyNFlOzcJ2DMldPFUXODhUItyHbHu8-aoXsY8",317,269,258,527,51.04
"Kruze","g7LJaVD8T3y6execAJzjnFJo9lERSCG2LBzFcCx138UU53M",98,672,645,1317,51.03
"shelfelf123","KH9PKEGKgBhxuzu_IF8ZX_w15w1WdcfAz0F4nGBIBoAsmtg",36,148,142,290,51.03
"2BoneMcCubone","a-Q24Xho52Sw1xihddtSxbVw2MDRmmksd_nvUHKzvKocLL2T",332,298,286,584,51.03
"billy worth","Bj-7yTpw1GXk0PqynQancdwNveJACk-MRNjUFyi2zsMWSdE",435,544,522,1066,51.03
"Wuju Senshi","comBqJWRjOCtw6nKiJMXk4Y7jBB_dsI_7y1u20qPXE-0tGI",207,275,264,539,51.02
" ai yazawa fan","3SKNJc0vB6i4j_GVpqO76EsovyaoHW-0uiHMaXgoCiL6wTA",222,573,550,1123,51.02
"TanguIarx","0WXoWyRF9NEIPHMQe2GRGHnfgbgYsFfp-2TGKnzjSeqWXvY",358,651,625,1276,51.02
"Rageius","scS7qplwQNWjgcTIDIIGDNuoC_TONtLhVVisIDDEqowfYsc",12,726,697,1423,51.02
"Hochelaga","8dqmEVKRLMwiIWsE1ek-e_YHaKTqxXvn7v5gbJwc0tgK1y0",8,427,410,837,51.02
"Notzu","EvfIQMU6uvMBn2SIcpxflKpPWxYYeZyJjPQiHl_M1C7cx_g",217,150,144,294,51.02
"Empanadïta","J2-sH1BFEyivOALA4Fbwb2mcODKoJs6tjl7kgTRdfQAX40LJ",282,897,861,1758,51.02
"Aethal","8dQSmBhZgCTi6wk9UVk7ZU7YH6bihpcJj6Tt-UCjcoLKomyQwgHoIFpNfA",227,277,266,543,51.01
"kT Mehjojo","NrzxCOyhfCBPYLAxSms8JSUfa7G7jMoNZ3MfA63KyQRA_5g",0,254,244,498,51.00
"KingArtLeywin","o7It6z2kk6XeRRJR2Eu7-LDS0zKFDKWYGgPu6FLHDaSMGMtcjuNvPxZAqw",359,509,489,998,51.00
"pops123","_x8sSN6ZRnSTo953vD9YB_zMMRMYGA_v0KXR2frsZZenJYvf",43,663,637,1300,51.00
"Dewsu","ljalrsL2mKkmLNuauyM8c7Y5H5qpB3jrTzjr0t3heANeS0Q",226,408,392,800,51.00
"Zantimon","hMKVS4xzCO1O0U_Ot8nnYD5qPaGyxiOyIEIaNgHw8IF4oKOthMSBDhFo8A",159,179,172,351,51.00
"swaggreed","dMdq_3aUTfBxlFevaiq8TgfG97EtIMz3mRZOoq5k-dCj24A",236,333,320,653,51.00
"Blanquirroja","Bdt4M945_9T8cUEupZxvzlNzbuCUDypX7R3i5ozMXOEPgCE",29,537,516,1053,51.00
"Toxic Asol","VTYtbXxvLzK-k5UKd6F97Oa5ulQSXR_WstkNUigZ_7Kp1Ks",0,153,147,300,51.00
"ßK201","n6IgCvvhuzJoFGwMOxxPQjSALQGqgKUdnKgguwZxY_owEVk",248,741,712,1453,51.00
"PT parasol ","3m_RecchWPKQfzganDrFMnaCPCiOa5se29HWzHTswROnhV0",11,204,196,400,51.00
"ZombieOrange","36JKPr3W41HLPNLLZJ5wKpbNNtiaQG10ao-unwOUO5OYkGs",124,154,148,302,50.99
"bark go duck","FGmOc3Q_omu0QYgHg-NacklvYcJ7_OQntZMVPHGQNFFjeEI",119,103,99,202,50.99
"TTV Apexidy","_dKEzl0FUPa9mDqxg8N_uQFdBfeEmZ93y68XwjhcDlX8ecbRNCugEXdwdg",291,540,519,1059,50.99
"Rim My Hole ","uNftQg2Qrt3FUADCN3zX1G9bh0lm-O2NXxyrlN8_kjWnZ0g",295,258,248,506,50.99
"WarnedJacka","ZeZWM4bIJTvGQBGdAbgkPnfVOg52gy7keuarwCwy4Au9vJE",320,542,521,1063,50.99
"Shadow Assault","dyIjhmdjKkrWRYSMjfqOH9pW2jrZE5S7RWMgt8UC__ZzbBQ",32,129,124,253,50.99
"twtvDoglightning","bZ3SPDNqvdixbGV_VT4g8dAKFUca7RDFqUWgnJVJ-waSG6Cy",470,335,322,657,50.99
"Lancelot Link","QFgUYknaMcIM8yeDYvrjfl6sTEelmFdt_dSc9BLXgQiUT4U",281,334,321,655,50.99
"MOONBOY76","DWRU3pxZIdF1IQGCKFJstopQI9SQaqAh8Nzj24gCqcl7V8hT1KFL6rrvAQ",187,573,551,1124,50.98
"Huo Guo Xiao Zi","kavYqODWkxoL814rBhe07yIgcnkBO9GXW0uvx7sb5ajtYLIpJvtjvXpPeQ",361,78,75,153,50.98
"SuperSunny7","8oh0bIyHJ-x9Ujj_Lr1VI271L64hifiMbXh71L3Aq0GelCI",43,104,100,204,50.98
"byeol","D0igF415MTOD7_xtrshN7FmVnDBZmQH0kk6wpNgstYj1HVs",161,259,249,508,50.98
"Gaboomer","XO_J_05E4jqTbu6oHw3VIWC4_PZQ_FrsUyvZH8kkU5vJ5StD",223,286,275,561,50.98
"PastIsJustAGhost","sOdk40VXMgWW3In3hzxIdr54AwlPsbYCUotCRqTcIhBomasb",442,313,301,614,50.98
"Heal it up","TSEEqeBvXRtRdU7RP9n89RXOVqgtaO9sy6BKIO2lrPuOFEM",0,653,628,1281,50.98
"Putilt","qeOYnCd638uUTwhq5RtqhljNGF3Kgsbx_DtUDtIXdaYZZ9w",428,259,249,508,50.98
"100 Dan Dan","ELzoxOU9EG4v1innqadaXjkTSvvQ5DkvirCIKpVd8Ps0zH3uoPbi-l-amQ",292,259,249,508,50.98
"Owlbum","uFeTux5ildP91FYdS6xO33SwTWx_LAJLBUkjZ6Q-BcRKIas",248,342,329,671,50.97
"Ai Love You","wrw4D9i2H_hsYMxKTOy2O7pjH068vughbe6pSbjEHYmMNDY",363,341,328,669,50.97
"SlayerSupremelol","lqT0BFXt5n9_IyumF8PAxdp1scW4Un0eqior7xc8FwLL3SFY",0,262,252,514,50.97
"FLAGGED 50521588","pjqWuwXo6NVgklRLgsaqlLSQSspv_aELCTtPpfd9lEngk7I",86,631,607,1238,50.97
"Mun","VjzcrG9uxYjm-IKQjRw1p1Qz-aaBvDBNaOoKZQb6KfoyIrXn",188,715,688,1403,50.96
"ZKG","OWEPfT_0XfZHnlGN_S1jNz0gD5PybeC5pPoFDm3d-TS3jOE",235,505,486,991,50.96
"Low Altitude","u7MFmtOE9XZiDEJpup_1wlZjF27Lixpkj8JeLMjKvuoSIyEr",187,213,205,418,50.96
"Avoid X","sp0W3Z-053i7r_R2N7Sr-0NzqJZrqCJWjH6dvvNWRoH-zUc",310,344,331,675,50.96
"Hao Yun Bao Beì","lRqALqDlJexplXZu_72gv-LzB7WePqc_KRYFCVw1GXv34Rw",87,293,282,575,50.96
"Toauieini","9SuYZMwLDWlgadT6Lmo0T8E070V-TY7fG1ULw5tWjCD4tUysjrCXMqfs1w",41,608,585,1193,50.96
"fán rén","Eq-IleK56Nv0mgYcDAIAOwKO1BqDkOFTvdn0cTH-78vEEMo",14,212,204,416,50.96
"Somber Soul","B7kGFI2HsU2FrtrAK54Jvs8uNGH3wiP6NCTPL8rzIdmWySQ",253,160,154,314,50.96
"Daddy Jame","vb2TsPgCEHRN8WWupSgl7iNPc7dzrFW2Q0LrqwUxCd4NlPM",1,186,179,365,50.96
"Møgie","i25PyHAKuTVT7qMFdmbSXaJLxh76MA_fmlZ-igVUdkZjgucA",28,292,281,573,50.96
"INANI","Cjwdegg_YD5bJhJKL8Hn5Ob_qise6v8YpBEgenQMzp7mbmU",130,481,463,944,50.95
"Ninja Doggy","owwbbmzC6a7wEiXtXjxZ5VhLTOYDc1OORvWt5NPUyUBl8S0",112,485,467,952,50.95
"PRK Maxiblob","kA-cM91t9fA4x2HaIACASxLdQBftjg_oRExIisBPhZWAfVVpb8nc2oSwrA",187,188,181,369,50.95
"Yunah","T_jaHC3EzTzExodZh6FYT1_AiQRJ2tRivntKmqsfDyEazQs",347,295,284,579,50.95
"say u Iove me","i9GhvuuTIxIJ-4ZXNsGhRvmL2x00B2JqIX0ZngEzedJRuz4B",307,215,207,422,50.95
"BunFuu","HrertYKBrFGl4VtH1QmDWc6HeINPXkbO1OOUL7boXVoaybU",240,294,283,577,50.95
"Cockroach","gzBYRGA4YOlXuSXbH5RniiiHDHRNtjB3yfebFSqNnEUYKtY",124,561,540,1101,50.95
"top diff game","NWOo2XaG8RDFb82zcLwKslH2ITDzqUO0OLvdnUACGkX_e0Y",30,644,620,1264,50.95
"Aldnoah","yToi9TrkwHBbSXCLueJdAyKXy5ghXGNsHUqTVUfbFb3s6Cw",348,455,438,893,50.95
"Abmis","VEVj7SAmppF0aLB-t36HyqhJxWCwXb-GUWyHpKndJqN64R0",235,189,182,371,50.94
"LFT DRAGOMiiR","1-yn83c-M9y6VOPXy5wW8HTz7XaiRQmgB9V2yErk26ntCq4",306,625,602,1227,50.94
"PykePentaNA","xIDF691OrVDAFlM8ldcs8-5OHouyKJ4XVgo6Wx7jFYNWm9xm_d_LwCv3bQ",121,378,364,742,50.94
"TheWorldAtNight","BlE-xdYTfnXNA77bud21dmEqSwv9p6l7U0NIwx7DoyXrkv4",93,81,78,159,50.94
"Kimitoe","_oQgsIQDcAlftNCdBeO0pm3hGkYhOeOE-SqsXA-V7lIf8HFl4yujBYoB3w",10,27,26,53,50.94
"Beeg Beeg Yoshi","37-UGNOETeoeUSeNyHcbpJ9LIzqAsJR8dVTynLh3cQIFPZc",255,217,209,426,50.94
"sojido","oY1mUNJHGfYiPNMZuwD5mCkmD7s68c_1FVUlHKo7L2fxaso",6,328,316,644,50.93
"Delights Garden","1ACIxpDtztxkpfNR5BrkScYo8pxdyuCFU-Lsdvz8wINoVTvsLNEU1BokFQ",321,222,214,436,50.92
"Snoop Donk","RYDFYqM1use9bczH3_gxT2ZU5GXxqNpCawLOBNNfuVsjRZA",14,276,266,542,50.92
"AllAero","1B6aYdT2pSWPIWFuKnrZwQEZc9pLg0VyDjjU8jvEeoXuwx4",0,111,107,218,50.92
"who is impostor","BqyzGm6_HdZRh6pbj3i7chUeieDcsfePpp-2r4sXvkL2ALh2Xt3CJsyzLQ",260,331,319,650,50.92
"Saint Ghoul","7GFi7s7tl1awY-VzbqW6IwVdYwXSsuCNjhw0nPs5fNZmg6Y",369,414,399,813,50.92
"Benefactor Sam","PvOwkXQPJx0cquznTuL8dHgeOfhKSdIAX5BlN4cjq-nXb00",170,718,692,1410,50.92
"easymoneysplash","LGe4vG-p9OH9KhtaJUVB1arcFzsqbmKQfJSmp2jb6WQ4P40",111,332,320,652,50.92
"Awk","rHlab3QlpwF7HmrFnvuzOHheKiwuD1qz14p57fXWV6Qr-Dg",1,250,241,491,50.92
"AShires","VhJW_dsVIgO_fcEywiCVsIwFpPD0jmg5bRQe1aDBpzHFTFqd",0,883,851,1734,50.92
"Samsâra Top","wNclRS7vAxUqTE4YpeQGj-GUPcHXK7mSxpyQxHHh1FwSvYh-r0cItzV2ug",149,222,214,436,50.92
"PeRseeO","n3-1kasJX0zTh--z9tusmyfJX5JP-wpjo43xXrrEa1kPbfE",20,279,269,548,50.91
"twtvtheyegah","by4eKIFnNHXDdz1PpE0FXE_qgVM8y55ScmrEMfzpz1ch-lC38vMEms9iPg",50,307,296,603,50.91
"SUCK MY CLØCK","jROtdG_mF3B8O8Mnm4ZyCXEFmSidZBk_U8vUWyw59hKxUl8",160,223,215,438,50.91
"The Doggo","GHBB6keahTb2cuCbe8sYA79SedKnZcTUzC-ku3CGtBwuw8A",117,476,459,935,50.91
"Petite Boy","jEENOudS45WvCM86ragJVltlsILGE0P-Uwxgw1lvnhYTqng",40,617,595,1212,50.91
"Hyg Mentality","hVpY7KQNS00IewKJZuKTWF7ZkgS8eqdbvELesdyrldkTYqQ",428,502,484,986,50.91
"Raynarz","_xOLD1ClAqHUqSmsRgO2_wtAxgM6DhF77HgVAR2u8mUgWw4",367,340,328,668,50.90
"Døraemon","6wekX1_ZUt6k0bcjQsEsSpr2IjOI9FGdnEmPJY9Z2tVASSk",365,255,246,501,50.90
"TwitchTvisaac1v9","EA49LaJPhDwrEH8414wyheAC30l9NBTmEYyW3DXJlp8Drjat",8,311,300,611,50.90
"Nukez","RILc3TOpbX1UdZ07bNGH2ejDw11gPWgN6JM6MiV3ubV0xK8",117,341,329,670,50.90
"TTV itssDZe","EURwSaDZtDBllG64esvqB-NWZcH5NxDwrd5SKaQHnVzxusk",215,594,573,1167,50.90
"for fun gameplay","uannBWHFdL6PeMEnsiBpObpoGJyyVsaMN3wCMCb8uXz2QoQ",215,200,193,393,50.89
"Saint Frost","2hkfDfjy6nTQ61RT4enIha-FAEDMDY_3wstMYXot95u1qHE",118,258,249,507,50.89
"Kingbranflakes","Ah-pTMdM60_x56zHRXn8AR8LUNX5vpK8JDqwaAK7kYBJHAk",283,228,220,448,50.89
"K for Kimchi","nocb_nfezo3h57UeDQLdSesfkvjccs41vFBihXPKJvaOTTc",267,228,220,448,50.89
"CuddleSnuffles","9SsWB51rFjjyNVS0-FKzVH5hqodk_92keCSG3i7Gb-g_--s",248,456,440,896,50.89
"Saeva","Mep-LN0BDWyaw-uD-W33Rbdt8JDBEoYx0JALWRezNbB-ZjY",162,285,275,560,50.89
"Binkx123","SjY806uX3fmN502oOIFdGahykJ3DavSKy6XQ_-RrmBeTVew",441,517,499,1016,50.89
"Gio Monster","gv6aRKx8cGwLhwjGlPcy-drnexhf4jeQHeIcKqkMUGsvPbA",166,258,249,507,50.89
"Bu sheng qi","atgVpkiVchIWEy6RHjlJ2FxGJL38oyr4vjAzid4oAiyQDhKe",0,143,138,281,50.89
"Arhu","1RfhPEbkrin36b3eisp8ut5jHf5R14dbvZV0OAVH5oXP7LY",37,314,303,617,50.89
"FA Heartbreak","x4VW2XlgF3pzrSLra_mzmxT7XqJBXVDWiVQ2pBqSX73LR0s",323,548,529,1077,50.88
"Nisprel","V7un2nTDXeWTp_8CC6GhUhOkXS76LXsiM2pvdrSpQ5ZvFAaU",70,406,392,798,50.88
"Radahns Horse","UXKGVmwvMALqhL0Fn-SFI2iXeExJonX9aFdDXlc9NuIU92I",454,808,780,1588,50.88
"xxxxzzzzz","PrdbcCwrUiyDUE-4pPE820XXGo31xPdMmuw-uR0LPtdqjkg",207,260,251,511,50.88
"kikyo","fdtC2XkdeK_NX6su6wUMoDWPpfRwVDLkmF1zAfgeUHGSEGBKVzllSp8x_g",76,523,505,1028,50.88
"eddiewitdahoodie","2Jis_2uuVQpoggi7D-tLrNCbPRb_gEu6cRxfxS1jktsUhDQ",172,260,251,511,50.88
"arbrio","5z_dWSIeXYNGgypQNEMJxN8cSOK5QoUeNgiu8KkjB2d0omk",32,779,752,1531,50.88
"duck bao","QC2PH8i5FXSrYcRY0vuz6qbbo5VGFpxs5sc3jRh6KG2L6UQ",16,232,224,456,50.88
"zcxc","3VD-G3TpXhI0CCMXp8jljZxWvPF83AcQS3S2TXGBGe3LWNZV",308,261,252,513,50.88
"Garen OTP Moment","Pts2b1S9BAS5U7NPFOpGl4PQVahxuFYUKIyVo68uNHsojf4",268,262,253,515,50.87
"Drazmere","D7t_687Zhfu9Ylq3eCXWiZG_EmV7AvsDpimmVHQL7ekcYFrD",443,612,591,1203,50.87
"HardstyleGymGod","aVJfxcGPOhxNutR05Z5Ya1oq97nADBppCO04zhgLr4p7Oxo",441,441,426,867,50.87
"NA TOP G","8PgN10TiSuiPLEj5pWHzuJrVzWP9qKtifY4KYSM0J-xp3Yp_",231,411,397,808,50.87
"IllllIIIIllllIIl","6XGXrgFSb15Gy2f-dx9n8FUGV8pmU1GR9VVDs2SNbhCwz9qO",403,560,541,1101,50.86
"Sevrin","rUZQip86lU-nuKkbynpAzEE4pl-MlsCV98LUAAlv1qMbWCo",132,325,314,639,50.86
"KerfaaGOD","EHIcgEUYNqSxAvV5LAh0UJsjC55Y_yoGcJj8Olex6-8Y38CI",364,412,398,810,50.86
"Shaggyy","MrhJ2qutdhZC06gXxx3gTddk0vK2tbKoqtus-1kXJYBmKis",104,593,573,1166,50.86
"SG AkaIi","wzUIQcH6LLRZ3r5n5ZaBBD9GUjA_RSJcu909kLpz_THUMZY",18,326,315,641,50.86
"Vincenttt","NCwdWUjWD_6_VoGZ3gwjnCyU0Ko-XKKP5-boDIZBDaOtLEo",215,298,288,586,50.85
"LIGHTNING TURTLE","dqbRgsNuLzlruSIwvyRYxPQplKFB99927Yi5bUZ9WzKBhjE",101,455,440,895,50.84
"ShleepyHead","inD9uArFXJ-BuPuDPVac78Pjg2Nt_55pdJIeY9RhH4nYolU",423,791,765,1556,50.84
"Masuta Bikuta","HgG5YoBsZ5zGEZtk640zfcIuS_K4JrZi7eB-4jASh-RDx-E",122,243,235,478,50.84
"MybuGlofen","B-QIbyX61CMDKieap_lm4p_4ERlVZ6huho4i9UPNnAbNYAnK0VxYdFcsEw",203,572,553,1125,50.84
"factually","nzdHsnb5PSYpaw2Iis27nu4Y3AcQTFn6iJTsc6uP_4AmPnI",93,302,292,594,50.84
"Kuro7","6QOBl7ftzdG6KXRgOFQSf2LEEORy3mLar19uaZI8kfNrq9U",15,181,175,356,50.84
"Toodaloo","6KaV5iyKweQk0Ih4bnstXUge1wXGZCqhQuM6gwIokMowGnE",30,271,262,533,50.84
"Eastan","ILYzj3BnG0KtZk2GmK0sZpJdoZsk-NlFrjEoLcA0-vfYt1s",216,151,146,297,50.84
"Bashamm","kaKFofgO0MWaqeY9YI2TcrEEgUk2RZlnNY_E8EQzUmZWSrE",103,241,233,474,50.84
"Sunn1","wCA-Bakb4Ho9F-Ljekwj_xTopZJD2OXoee_dWbYmmfkKj8M",6,212,205,417,50.84
"ApeXsnipe","ppDbnv-Nj_QeWUVmzb5wcWs9XYYoAvjr8QV4bvszbiTSAjA",255,276,267,543,50.83
"Diwatang Baliw","_rJZA78mTG3uiabIQCihulKmQVivlkkfAd8bYC0AuNw-1M0",191,122,118,240,50.83
"TTV HonorViego","pdpBVZrbWbfQG6ZifRXxs2OK-GYXUiLRwqc-v64QP37goUiNXtdfqlanKg",143,643,622,1265,50.83
"Han Feng ","W6z-Ezq3Ndu-LjOqW06Yx6cjYrR1IZpbiH6ZBoI_AsF9JnHM",145,123,119,242,50.83
"ShadyFM","MxdN2hjpsJZmD-csKyuyVu_Riol8bdsUcEsLYtAp42_3Y9M",206,153,148,301,50.83
"Draconus","4ENbsjKCAUNdiG8NWmvEbBE0geGZNdPJLptquYwXMg9s3us",1,553,535,1088,50.83
"Clemency5th","X1Q0tDzcAGZ_iJmyRcrh7sp3VspGi5q8X9RN4MCeNPaMx20",19,644,623,1267,50.83
"no one compares","BuOfIi6TtZ1qWLwUZNGZpLhXBiBw7oegImcam7grtF1rp0CD",3,155,150,305,50.82
"kkgbyn","gTKyInbYgrc1M4bseAm_RsqWRZ3Jm0fczLRtEuObIhuQ8Jk",269,621,601,1222,50.82
"Habangbabybread","_P7btHVXBcELW8zOI69RrUO1O0pmtGjRapxlnlZgivcVDUU",121,1055,1021,2076,50.82
"get milked69","D9j9QamVtTGWH1UnkAJUiissPn4lQV6pGQW5BClQ4t3lfxs",103,124,120,244,50.82
"JBL Speakers","r-O1LdTvVzD5w4oA1vFAK_HVuOfge5ePBs083hxdzmHd_oE",376,373,361,734,50.82
"Doopliss2","aAB5xgQgQ2PSC6D1geE4pg910eoWrjhV9NRKlVTMgsM0w4kKEk1jrtcCPA",60,248,240,488,50.82
"4inch is average","2j85GsbgmmqvukEyUj-279_xaYYX6R-HhKvlGK6J-A7eCeA",11,93,90,183,50.82
"iarukas","0zMNiFTY0vN5p7e3QgJJ91el9A5mqteU3vg4KhwMTCzGDhDR",0,93,90,183,50.82
"BeBePro","Xcj_E2RKg8vJMMOs4uOyw8zZJUUJUQS0WYKf1-L49Rp9WK4",302,157,152,309,50.81
"Soju Rain","nTI9tMLRAf5PDW2JUOr3XST0xP8bUG2KROLA0TzgFgERV7s",331,220,213,433,50.81
"Kcusmai","mDsBeMWS-P2bnkhwgKjcsyXYk3QBXo6eMMClD39KF0jj7eM",52,284,275,559,50.81
"Do not hugme","DuUPsSO3jC7uWYywPqJtcCh5stzD48VwQH8RzwumTQgTDmAplshdkJQSIg",438,598,579,1177,50.81
"Maykel","rtDT2qSkJC8cUTfmb1guHIbVfYl3eDINdp7h-mQLHAffp0No3n1WyQId7Q",185,406,393,799,50.81
"Dua Lissa NYC","m24SKGv7H-Bcg4kYcssmgHqI780-RutLeQzzPqJSmByW9F-x",419,442,428,870,50.80
"gab1418","enmUKW87omnVFALEBCuItwiSQ6rbGJHtUbDc6anX2mVK4RE",61,763,739,1502,50.80
"Poz","EnjRFh0SurpLXq3XEc74q8nNxXWODGFuFpWkk3IaJQ6tHik",161,413,400,813,50.80
"help on the way","WPpB_xQtIqZrIBuWPA7wy7ZqYxeuknypfA_JnaRx1iKmwRI",491,474,459,933,50.80
"Leoto","ntaPNnNyKmeXR3v-ITribU7_GbpeFc26cI-X0FiMyqQ",186,285,276,561,50.80
"Geeega","aiMIaVyyITnmBD6Xw40d05A5wRrC2GcCFwD6TUvSJMUcC40",151,320,310,630,50.79
"Yasuhiro Takeda","xkbpyiveylSUpZGcvxB9QI3vM0rNkBlC_h-dXsoMiHn_aAw",230,577,559,1136,50.79
"Erick Dota","XE13DsAh6Z6RrU87E_58qDn0JSHxmDXG44Fpwc6DKLUd2YI",301,767,743,1510,50.79
"SuckOnDeezBeez","mcY9byx_iZXtmJJbyyeJ-tcaIn1Ae6-eaTXxI17WY1h6DS8",248,225,218,443,50.79
"Intensifyy","HdTZdVE5C21NkyoztO9abbsDYseJRq0_KlZGf3-24lDFQHY",35,483,468,951,50.79
"KissFight","UNlNBn9YtY_T8Q1UbW2IiyqhIPlxkS7wOZfEIXhakqfW06w",366,128,124,252,50.79
"Sir KullJerk","Z6Xy2brWPg6jXJipQspSTNG3Jyui2lgjl8xMEzUTRk36OI94",204,418,405,823,50.79
"listenDogs","8jOIkhyZXGZVN7NMMt5I75rErNpRH3wc5HZSf1gb6iszaSk",263,970,940,1910,50.79
"Scrive","4osRxnKkl4LVrL_od2aHrMCin2bmFaT_rL-JwxFdIo1SuHY",149,224,217,441,50.79
"meiko1","VlO9GqpsgbTgT1WgdRy1ZyGE1XJ4swK7c1xT78b9PVGX3l9BJoUKULq8Vg",195,192,186,378,50.79
"Kyoriosity","NowbiGHPShBamOx_TDzFbsIN5sM6BThq5P75MOw5RFSGF7I",40,130,126,256,50.78
"eL eL TRIGGER","OFAg1CMq1xfyZ8kVJCDfp_rr08LTnFVOLGpfBkEWxzkETuTV1AMyebJw2w",257,229,222,451,50.78
"VÂNQUISH","BeCeV8pBLTXeJ6jV1cqVoww0nHUHTgSyu4Poz3CD1EqBH8M",29,324,314,638,50.78
"Jayweii","-0TUrVCVYbrs1s3lLDSiaJTVzFeTxRhSaZv3KpIaPozouAY",50,628,609,1237,50.77
"Taffys","F8gA64N28kihTxZJyPkbsvNJWCk5Thymiq--ame-I7lTgBI",422,595,577,1172,50.77
"JokinenNA","VNHRIRsv-qRosvBjAby7B0pJ5ssVkHKxhAcEZpZ1qziO6a8",87,263,255,518,50.77
"Barron Von Boich","e4e2xIYoPePS0EETSZEBya4v32gEvKdbTSERyjnSMCT610xv",173,231,224,455,50.77
"Kęii","Yn8n7sYvIHIEsuXPmNg0CSB9AlmooN0Mn_d9fTZWx3HjfOHn",222,265,257,522,50.77
"D3VIL DEGREY","saZQt9SXCV7Pi_U6WuNxmOeNyssrFYo23I_T3T3Qi5IJ_7k",205,662,642,1304,50.77
"Barry Buggles","Ns4lFAQ4g9109HUXMa8ElQCwUhGf04xrJUEgElpYGYtrKLE",324,232,225,457,50.77
"DEMOTION SCREEN","LL1r29Scc3llGapwbnN5uuypMR1Qld7-WDmrZ1rGeHQUiX4",260,459,445,904,50.77
"Mike Trout of D1","9Hkr3GJDcdLY3dXIITpi7UFajj-yR1lE759gcg9lTrK87UFBiFR7vomfsg",0,557,540,1097,50.77
"Levi Pug","vt4GyorUoroqTQRzYFRufdm-MaRzfKvl1CLfb0pMfroJAwc",94,200,194,394,50.76
"CARPET JlZZER","kOP_0VhVAMdI3yzVRaGX7ONZ_0NFqU_KM9H9IjGszISciQE",1,366,355,721,50.76
"Emended","rk3JWaevKLPUADBJolQ7AinFton8hbaLFT5xJpgN6Mw5BFM",210,234,227,461,50.76
"Owen7","jijSzYM8JglscKf6Nmz79D6I19K8R2KnLxqjHTJQuKTm6KA",119,333,323,656,50.76
"Goatbm","GfpwPpgknjIA6zPZWEDIe-u-X-qe9yy0QYqtHlUbNsmEL1o",136,573,556,1129,50.75
"Elee","GshiO0FmP7LfN2QwGUObrjf3mRT2tXK9s4cvSC2hZCK9VPA",0,340,330,670,50.75
"Navigation1","je6j_u3HUh6WH1m-QhLw5ypeXfIP3_mNJK80BX6qbGMWwco",417,814,790,1604,50.75
"AsianSuperiority","wv2o3LWYrJYLpT8BXyMgPG7agEhFJxpNct-6zCfKHU4zM2E",326,270,262,532,50.75
"souI","wNLdCziHo3KNoaFTgZpUCchohdoPGI9WBBThci9Khq7vO0K0vSeFCTZwEg",43,305,296,601,50.75
"Novawa","4gOKjP2RVQkqnGjkFuP9wc738JfJZRVcfKiAEgst5e710jk",49,639,620,1259,50.75
"ADC SEASON 10","JE4pY1kwNNVPTIpBlxv-fXNyICW-O7VV6U-PIaz4FH9aumOU",30,441,428,869,50.75
"OPG MoMo","l4W_8ZNNL62wGpxe8rsASWXrGMXRXPI5hKVvwJt1p_MqVSD-jr4zK7WCmg",1,102,99,201,50.75
"TTV vsekai","SDdwY5Uc5UHAyis3lN7QFClNYcl5h1PNh7wYglx88Iu2fj4",317,681,661,1342,50.75
"rhuswok","9AJIU76XJGu60ZU1A5Jo8X5mb-JvjNfs2ROTnSm8o_WVu0Y",1,169,164,333,50.75
"VICTOR PERKINS","IKwugMBYFG1f3im-ykTKgO-9ezWB5gFujS7r5y-WmtrBXgc",214,137,133,270,50.74
"Abendegos","QkCATcwCiFi8va03MwZPVutFk2zbJxqFQy30a6JdGATN6aV6JG-sCDVZOA",1,378,367,745,50.74
"Zacierus","md-PfSrihV21lYa2eSoHyb850yPzAuatBSacSzV8WYtzU_U",383,649,630,1279,50.74
"ChorionicMean","DZVDUqjkytu8o4SctA1rP_31Gvgzt0cTM8Rryj32YC_9dHw",142,689,669,1358,50.74
"Going Home","sLwv0dehwHHaOHi0Wg8KpQA3JeR1lJ0H4zwzDG243o0_6rw",178,240,233,473,50.74
"FINDlNG TEEMO","kJ4asW9dKxMNUIbKLaGYtatEu_8PM8BdoT8im5hIv_1_E-4",296,239,232,471,50.74
"Sir Mighty Bacon","lrQQVsSrxWt4nXWbr1lSCmC_Q8n2e2uzrCnLi5bkIZ0ehQY",153,138,134,272,50.74
"taylorswiftfan32","vJbXze8Rld03iOqvuCm6lUu-LMrf9vDmmBsGyNYrCXDFBuY",95,548,532,1080,50.74
"Braindless","a6crwWrOdk_1LR5O5RuBssUmpiPw_g5zUnl1O8dwNf_vZ534",40,241,234,475,50.74
"SevenSevenSeven","1n-nXX_EKNmQ9TqX8f4XWbodnZSI5V-X0nZD_r6t0jQ9lcY",40,171,166,337,50.74
"Nulnul","JmAew7I-tiX0BC_Xe6asJXB1PDwQ007YjQsD-UsLAERNsTMK",223,103,100,203,50.74
"Skum","KLjas69PEVZg_ihQef1oU8g1wFUIZWcCoWAcFCXlabfVvQA",58,380,369,749,50.73
"sprinklrr","2UbDX4dDlfoGfg88QkTJC4qb_2MQAuPhom5JyWYhD1PT1X0",281,384,373,757,50.73
"Best Turtle OCE","LohLV_r6aPXwFNiL8MD4NCeDMy3Ko9HmngwOzgYJV5F1Gao",404,246,239,485,50.72
"I Shadow I","jblZ40S9QDeUGQDb9FpP_sVBgb-YEOulXvxKCdlijj_HhJ0",315,319,310,629,50.72
"ME CAN WIN ","xExAMZ8LQ2wdMomBsBH2ovNP5F-za7AslhxDwjolKTpySQU",309,210,204,414,50.72
"Always Top Diff","QQoxnwRMjDTcLa17WEHPang9MfxkVnXVImATLszHaFGr",80,851,827,1678,50.72
"CIoúd","adjeC5Ond54cMO-gOByglJvKTtV2s6KijkgrUwbgE0hiYyU5ZiF1xGg2Mw",403,424,412,836,50.72
"BABYNOW","e2cRQixj2E2zIpZPOijTl1yWU9lo0bvPPMsFE96XNNnPwbh6",253,175,170,345,50.72
"zero xiaochou","XPAirVtoKu7voRxH8tu6bpKB7a4cFGFUCsoQCZtegxW5dYM",51,387,376,763,50.72
"catennator","l-m1XhQX_401Uzb3TyM4EHB4DMCzePoxPiZrwNpmWzvWGnw",102,177,172,349,50.72
"ygjklj","vFEc6gCN6mvUb17BLK8bxhpihvcTS37JV9Jp7NKvNpPw56NWXvqu9GfozQ",394,247,240,487,50.72
"SIKDot","pFedwEgAsT1Qb7-OUjkGyCjsAmjkOrih0tCFB1hZp_fGoKI",209,140,136,276,50.72
"yumichi","KisbKIxGenqmPj4KnFxRBz4h8u-jGOdD-2MvmnNfPbT4wGg",23,636,618,1254,50.72
"YeetYuh","yRoXxLqrTQoltyEoz3xpL5vJOsx8FSs_kdGP73YjKsVhEWQ",59,143,139,282,50.71
"care chimba","yaKahh8H2UuhDZt8Z2_PgeF1kY3HvjcB7Z4vkUn5cMPCiSK1T9McaqPn3g",317,392,381,773,50.71
"King Koney","Xv1_Ult90yGDib1Q_khXEYpIHJz6ATVgdV4XmpQuthm8klY",259,287,279,566,50.71
"LPB Traumerei","_ew8IhCfiaCBbMpxts4Il6bp_j17Orl8ru1sf0MTh4fvYHU",116,250,243,493,50.71
"MA The1337Troll","Hh_jRlmCYhSAVp8kKfWGwiQyooW0kjeVT7byMJndaMmIetQ",93,143,139,282,50.71
"ButtBoon","EO84WqRhVJyP5P8m-KUy5gMBbB7e4XyILPa_QvUO3Hy8kSY5",66,357,347,704,50.71
"clapmaster3000","Wo-fmpX4GN1DzT9jVGPJdsS4qkl-dVB1rtXdclCbAG5RVcY",16,327,318,645,50.70
"hey im kevin","7KJhacE7xtrNsNQg8VIpOSbOZxV1xamHG83i1ZY3E7LCsJ8",208,432,420,852,50.70
"JąY Løve Kąt","tKbCRJQrBgkk6b9kZ2Iioh86oawCPPwWHnUIbAmtSlmhllU",318,397,386,783,50.70
"WorldConquer","zYJNE8X-SlOPTgnp_Eyyn1sj9WPc2R8dhNOjKwsVBA2SGdY",235,253,246,499,50.70
"Abditory","HQ0d_CbDN4c4mPV8fm4_GVEh_gAZhvk8IG6PkLfs6IRQsmM",300,144,140,284,50.70
"Yuune","rqmR5h_aNrxxBzLdr_KcuvgKnPeaMd6Va_1F7Lmbx38JS1rX",201,396,385,781,50.70
"BigBeagle","ZmVAfa02eLIZnAU5Y_IxezIVPOooZLa72uTWITFeCXoIGRp_",464,581,565,1146,50.70
"hen nan bu bai","EOh3IwBBDi6r_r-2TOSeOqOBY3c1-sLVB8RMGr54eb2BPiw",143,1202,1169,2371,50.70
"Trapanese Ramen","A7pbYI0S8tGdnY3KHvb96n1KMvF6lrmgKo_3gUJ8wKc3rRM",83,252,245,497,50.70
"zxzxzxzxzxzxzxz","LSav1ewNN2sdl2NaKcBG12yJOt2_nId-sdCQaW3wTbiBTGw",253,109,106,215,50.70
"Zahnet","V2xVJEV7g5YsZAIs-KlmpibdS3pvRxx7khhTOb3mlL7grAI",225,145,141,286,50.70
"Animalizerus","ClySChRJCc0W4KL7hoElIVfdldbP-z-BbLi3arWI0o0McGk",35,145,141,286,50.70
"Zülrah","wzVuSq_DtT8R7Y55RTeYH3AQnNuaD8euEOlxhJoY_X8rcm8",93,219,213,432,50.69
"lolyaoyao","EBkwNYvrEnD9LjJv8X9ea6jzPEABznqVmsOK4g6QzEWsGww",29,589,573,1162,50.69
"sgrug4","y6fX8-nEwbDO1TgdFCZ9gOMAefRmGod_m9mjMruu_Gd3B2E",226,586,570,1156,50.69
"A Lodestar Blue","pitHrIXkc_7L5-qqqce3s0kmTKa5vppxaY_ErL4bQ1RyXY8",0,332,323,655,50.69
"Harry Tan","2euUsnAvLW41qtjf8cPJ6b_fZifUzYuv7HdgaHLRUgt8m0k",1,184,179,363,50.69
"shaarzard","i488w0vmhbIQqREPoupc9GeGESzY3jVxScpDEiORm-yOXZ0",234,409,398,807,50.68
"Krozoid","br9z-OhyZgKCpSu1lq-3Odd6ekGlUMWLyVZ1Z3u0tVSZS7I",52,557,542,1099,50.68
"Murillo Sama","pewET96pEPwtL9tmr4hGQ1-hnnsk1fR6vAhZiOq-BPbds-1O",21,299,291,590,50.68
"QEEEEWAWWWREQ","WRsHPIKZiIfouPssgr2qMgIEKjqfk5SsqxWDn2AxrlaOdmqSKcRizfqxhg",106,111,108,219,50.68
"Boón","PHoA6PbZR4fFBaywcHlEopcjiWDC5oRqBqAUjDflkX_SSUI",181,261,254,515,50.68
"Talon Ego","cZRE3KdPGAO4Hmyz9RDzE_ZZ0OPO3TcjwYngPwFufW5e9lAg",51,185,180,365,50.68
"Arekpro","q5jpngrDyc3wyJJW4eMdNUithThXjdgFesyle_HILvk-z4c",20,112,109,221,50.68
"RNG MING LPL","MOrGCBhX9rZkRNm7zCE6UnKiXF4XsxVz_A1uTM0XHwwO0F8",329,414,403,817,50.67
"Rądar","3t2vTgVLHQybBe9xTllpXh-UtQQ3SGpv2ucQvah73mNc7p8",444,417,406,823,50.67
"UrethralTraps","yGx9QYery4T8gyqcVA04kUJYpBx-sjQq3mQM2Xtxm7-Bi8Q",1,266,259,525,50.67
"Outrushed","omTF5uiGP8BZXCrfQk5ZTSPUc5Zb8wOC__0y1snVEtgXY8w",204,607,591,1198,50.67
"th eggsalad","l1p9Vs6pw56ZX3wYTb2cAqwWivlo7ojmSG8wttXx2-BTvQk",319,414,403,817,50.67
"TranceTherapy1","I94FFadVnY2dLUOIqdKz_OooC0ldKLsyLDepDW61pwsjQcY",46,76,74,150,50.67
"Non Sober Player","nUIX0-CUvUivKcI25ndZBXKQXgQ3oSA0pujLJq9zHObyzB0",271,457,445,902,50.67
"Coolkids","eagLaIiZjSlCEhlgd1GmksMDGlj-mcMDZpWZgRoGhaaUQLQ",271,340,331,671,50.67
"captaín zero LP","qwXwx4hQr4AXwDhH0JSoSg3SvSA5wW3gcgCFpC9j4HpEFtc",164,189,184,373,50.67
"Hans an Franz","v-WWqV-52IkKhApq-T0cNmfhDe_RDlgnQFbFgE8V23UhviQ",218,231,225,456,50.66
"Cell","D7PQg45zlU0n95GFpfx-C65QQDsSMBDidzEBuuCiic9DuaM",121,346,337,683,50.66
"lifeizpain","uvNwGmW4d4zGW7bTc6lz7WI4pn4KZxTmiSN1NIYV4oBVQHLy",32,502,489,991,50.66
"ibosama31","3HJM9qon9bl5h_ORQ3zGUWHMviE_bNeOpCFbgL_q1oqDpRU",1,230,224,454,50.66
"Jhindiana Jones","RI24bFNnfYqXIgmCwD_I_sELx-igOTtrWIhac1lGw1zIe5Q",130,153,149,302,50.66
"1212starxeiko","eHfhwg7zXz7pmWpEZvX4Op8z1CglMm26Y1CpmZ9MYzFFXOo",100,464,452,916,50.66
"BarbaricDictator","YUMc56gRbcBJEi-fWA9xe6aJ8WdVvc1hhNatlHUR5ZKJyzg",431,688,670,1358,50.66
"Suddy","w5sOrc85NLLluAI8leCPf0VJqQTzj94mRTv67hxfGNu8ru0",197,459,447,906,50.66
"One Punch Zac","tGmKx7kS4J_xoFJiE-ge6Kd4QO6O-3Z6Va6SvBabJMGXq3k",202,460,448,908,50.66
"valksoar","0xCRhUJE_8YU0KGW2vVVhn5u_4Pt0RbRji_qbVsfsee726Y",17,767,747,1514,50.66
"Boei","aqz4LJWDUo3qyT-Ga-qobekpcXpoXsmwLjU3hGQm0Gpexyc",78,192,187,379,50.66
"21 Stylish","X7ZEzhGVp75ZDUvTKSBOHMtZBzpib_wmAiwQosPIjPCMHt4",158,627,611,1238,50.65
"Kross","cIPmsJYH8-B56f1QsIJbBoTHkuf1leGsCYuYzgnYCTdY5Os",0,195,190,385,50.65
"KingClueless","t089hVcDVIKd6Af3BepxOsTM3xvsi_StW56n5fKaeqqapOk",401,430,419,849,50.65
"Quachdaddy","cUw3v3sWRVtx_QPdiWBMYrrzMLvb616Bpr8NN5JSoSSnJZA",149,310,302,612,50.65
"oic","wqP78_X91nhn9HVR8V4epQaJrPsNcsTOxhM96e8ZXpQ7RDDK",112,387,377,764,50.65
"ILLHYHL","QkvIn2skSBzyjYQx8kpcVCGn8ZzDzZRPhZFMXhV3RK59janI",1,117,114,231,50.65
"Crazy Joon","FdOUYi2yEZJmYRPUaCi6pnfRvK9z-AzrJemqm1K_DZqDMxI",107,278,271,549,50.64
"Profession","dlsim4j88VjwwXv6NHpZTmS2vjJN7tY-4FanGTjNsqNGQ4I",351,597,582,1179,50.64
"JJBMYU","TYcmFxg0vH1-ODb_Uqn9UNmLomsiDpQqUKaeSwy3mmNrfXg",301,865,843,1708,50.64
"Benhart Vance","sThe7oVmn-H4-uj1I4axEhotQ9NbFzw4nxt9drCu3jOIEP4",221,279,272,551,50.64
"Spirit Blossom","LpCLViQSgbttjlNqf7EPxxnk8AVxoprOlHVyuypCttglq0I",54,516,503,1019,50.64
"turip ip  ip ip","5ifhPL27lR5464ZUukcLrCzJesvVzrKjPHfLKcUQD4zR0EU",144,240,234,474,50.63
"sumodummy500","JC9TK7Wo_mzgOQYz1PR06_MCG9v-TooCV1h6xxYL9mkj",88,200,195,395,50.63
"karnflin","fCis7GSI6NEtzutlY-t-iBrIMwpO_a4NzejQKAV4HTtwSi7r",94,323,315,638,50.63
"hugego player","weqUucyOeLard2njM9wdD6aJVly4q_SoPXz9I1upt5SZznc",266,242,236,478,50.63
"200IQPLAYS","B-bk8AItFhPOI3dsq9WbxYTixiTtAMxfEkbxDWnCoAJFGSg",102,80,78,158,50.63
"Circus","W-PlJAz3Nz3B155eV2UDeEoapiAHtTMh0W8S38moagmyqU8",217,280,273,553,50.63
"Grilotrix","KOpkjdwimUAw3vnclGlYcKrcsA-JJGHIKqjfHgCwrA44NHE",0,326,318,644,50.62
"emPs","m-RS_PKJIfKSBh39aba_cE1Xh9qw8ELf5SEYvFETuU4PGZhE",28,246,240,486,50.62
"Destiny2007","6H5u9T8vMmwUNln9k9dJxYUoif2MOfoDajMeNH-VpwIDT-E",117,414,404,818,50.61
"Ziz","IvpBHVolxworobMMFWi0c16vG1lCtwv2iN4Rl6Og4-xnBQc",225,334,326,660,50.61
"LeBussy MIA","oobHXscpZTD4X9v_WyAAS724chQ2wtPVM1VI2_DUENf1Fos",35,166,162,328,50.61
"garbocan","MQe7WiMzJMUnNCyR-vLwtUA_ZdqsjC29cqInu90USdQNpgo",1,919,897,1816,50.61
"yunkk","iFghwAHwpMYASLUogWx3EB36k7Z6GOVOntVztmNuKE3aEQZxrhkBU-3N3Q",193,330,322,652,50.61
"Sambíno","fAa1lrGH7ryao9THYrbCfbVB08kX2Mqk4URtnm7n-q675tbP",61,372,363,735,50.61
"SimpleButPerfect","vHh9SwqcQj4HdVpe_xLqKAME1bxOVsFDJ4ESVYTwc6gwrM8",150,250,244,494,50.61
"Blãnk","IBS8vaa0g6tkFK7eaXUoKY5B3ygSBtR2bP-ymm69KCCH9BE",0,577,563,1140,50.61
"zzoe","2znzusyGoXGvTw1lMNS9pV60ky8xXBdMcNWG5TjtF2KLQqJ4",444,289,282,571,50.61
"Dìesel","7sE21WXeBAbv1aYnt5asSUENNj5nOz1BiIA4AWJT3H1-REQ",477,911,889,1800,50.61
"Froyos","6oOeO0Hb2u5hj-1MEc2dvWsGnRcX1V9ZS-ppBYV5szuJn-U",105,373,364,737,50.61
"ACE Ezreal","8GZXHI_KfWGwmfwXlMi_nYbmq_sWbbNkyhI6DPKrYmyeV90",236,499,487,986,50.61
"Hussey","rsbsOncreMt5zQthh2t6LWooy1mByHRMixKhSOMCock-9-M",184,126,123,249,50.60
"Squishy QWQ","EbyOPCQw4J2oL4D0NdGxV5BDeBVM8GH3H6yHn3sbRSWm6Wk",1,544,531,1075,50.60
"171 xo","vOGZoMceow1ay1vyS0IUBAHdBCqC_HV6Qbt9J_N0ml5CkWBW",443,294,287,581,50.60
"MoreSleep","xg8eck3wkHemoL2Z3GQrBqhDvOp8L7qP9Wmpj4WX6YXzwqE",285,212,207,419,50.60
"like a boss21588","EQPGLnv9drQl1jlQi3Z_2-OdQEcowrjBuMMN_K98jGPUFuk",18,335,327,662,50.60
"failure death","KTiyyLmWPxEbkcwqbbgjyeEE5gcEBrBvh0rHLyx2RdZbyBI",103,126,123,249,50.60
"feeł nothing","kodv9Yd0DX52knBj7nI3EZZKciKTex5IgrE1wWUtFWU-L2ErQ6bNTEdFug",141,382,373,755,50.60
"demon king stain","bnBJ8_zlbS2mN_lWRUfyDsLEIDijau0oDDzdP7djjU1I1_ry",262,516,504,1020,50.59
"miniaturehobbit","nYJykXWbPqaLlSAk72rZNlOsu6ScViZDPnDKYzZQjeREXdk",357,426,416,842,50.59
"Winded Pie","l-WsslasEUD8o91ii-OdVEjY71WbOJsRjjTh4KXG3EHLfEI",17,602,588,1190,50.59
"Never Story","fH1V2c_4PHspIW7N5AN31nhoRrUlehHRZEz2USDf0Za71BQ",203,302,295,597,50.59
"RiceLegend","rNzLZNNzbPqICKQxsTO1ts7-JrWl3PQsZc9C6hCSzIjWrLI",271,216,211,427,50.59
"Femboy Aesthete","sg2Qsm7i1eH6Wzj_x2pL7sOMptVMWjauHVM-gPb5oQIOEeo1",419,215,210,425,50.59
"Darcreationx","Mfk3w6jzbzyGf3ZH0Y2z-iCRUzv4E8VShoQSXaSGlsVYTvc",135,257,251,508,50.59
"zzzeus7","-5ync0c5kzKtvROKpfGAiL93yBzdaD8MDHCI9M6bsmX_Kzih",116,475,464,939,50.59
"beta boy","N6LgEzTAb0Lgq6METQLlb2vBbrkBTj_sQ8njLaLU8x3cigM",42,171,167,338,50.59
"Moth Meta","7JWiWuDb4zzSKaUjcdGobJpbVN7_eNHTigbC5L9z6H64wrM",214,527,515,1042,50.58
"EmTeed","VZjMHtEBxpayOxu3QXhyyZwjpuJ-5IJNRQzkS9LT3kNv748",168,349,341,690,50.58
"OLOUQAQ","X2G6b8xTkqlmls_aRZ7PMSCdfV4GN5bAbxXsUUmdlfvJYSQ",1,87,85,172,50.58
"Luv4ever","w3YhW4ixGWnYpMd6LjsyZj9jcn8NxJUr3TDuStV50Sq2_EGafZDbV4x5NQ",115,523,511,1034,50.58
"Echídna","EpV2kCH_jFmuZMlwL_V3uEHIdZMaNqvDqOUqtlg8MdRKxvQ",240,349,341,690,50.58
"FobAsian","wHA1ZO7SxKr02WQWm2AdFDbqVvjlOruuG24Vmoe8p5QjPKs",108,87,85,172,50.58
"yong zheng1","hytmahv3cDAHUVpRSUGwog5mEN2ie090cFSJS_h_zeLe",111,177,173,350,50.57
"Benjimex","NQQV0pGWdlpTML-neQK-8sV75nvhERCbHja2eG8EqcO9fJ0",145,353,345,698,50.57
"Guts","a2Zme4W62McFnT_03VfrY8004o67nfILGq3lzerx1WKJSzo",76,310,303,613,50.57
"bëgonia","Ds8OX_GADWcHO2F6oo7QjmU-A94gB6ejD1t1LatUvBl_j_k",69,132,129,261,50.57
"Is Tenderness","Xh13Ti6qo54mOWCgWpUNCMbC7Dslryei6GV_x2LnISJV87Y",3,132,129,261,50.57
"Rhynosaurus","DDcYCWL9p06A6IHBDVmNsP5bnmeo0sPdeGFzI4qb0eeX9x0",129,1024,1001,2025,50.57
"DatBoyBrando","g4gWUNhnZw0fRlq-AVU6GWMGa84_1rC18oRhV2khNV2EYBpa4-sSG_WZrg",56,441,431,872,50.57
"china","Gl4cqO-q9pO-RsoUVT8sH4FffHF9fJ5GiGRCKwuHb4kFPwyrKEkFHk3vzQ",162,91,89,180,50.56
"Soldr","eDQ_qfLDsSdSYHHH2S6jxw7yyWDoHsHduFlBZKKajTjQ1PA",223,819,801,1620,50.56
"BL0WJ0BPRINCESS","M9DbTaye5_TKS7vLFbJeSDhb_yInX1vs2O6cD3RWjwSy4BI",96,493,482,975,50.56
"Iuap","E08lz2dBnXo5LVEmLCnGmCAXZGxCWKM3HvargGv30G5SIIc",22,224,219,443,50.56
"AprilBornInJuly","6CCQS-_sL7eg4tfSDpDK-SwiahK2nF-yFitIIiKeGY7jeRw",71,180,176,356,50.56
"Femboy Kisser","dQ0mcDrQrqx9i1CBrqK1oIyqulo12rhcR5zk3Poeh2a4TO4",0,272,266,538,50.56
"around Yoü","Iurju78H-Pmcj5Ci7Ve6aJ5BkYmjBrQZ557mPlUvmCXrcU1o",58,92,90,182,50.55
"klout","aoN5KoAqvPeH9h4EO45R98-vPpBqwSSnk7TFdOcmqMxFZs-a",80,322,315,637,50.55
"Rammus In Boots","VOglqRsyyCyHxOvbMAUgYxvH56pvCsY89j-eYSijzI2uOJoGEPtWHjT7sw",198,777,760,1537,50.55
"raymOOnd","HTHR5Hoc59NXX25et9CQCVXk67Q-htiyq6WLvQexnpDteG0",55,501,490,991,50.55
"Angels Demon","2g4jUQ0Ccd5sUsRaA3i0ktN1OmjEQGmb55M27KZqEhnW_FA",28,183,179,362,50.55
"Cheekzr","zsQGCJQGZfI5yTZPTwvmT_baORaaFpb08Bhi-XLnN1yFUO4",380,549,537,1086,50.55
"itwasthisoragf","vqaWygYlWmQiKDbadujk6_35xzbPV6rodvyObFjaALTXfmqm",218,231,226,457,50.55
"G2 Idol","HNo0eDMnPqL7K1xp6ljd0UQ6zlmS4Ep_1K46ib9P5yVDrvMVIVZG2zxbKQ",1,502,491,993,50.55
"sammystinky","Hdlb7i4Rz3z4dNx10Tqb3sCXqGJNGc75YW4bz0o7Or6Nzwk",109,323,316,639,50.55
"Fafn1r","nGhGjLX2IQLZLZy6D4lLt0zzJRlMEmr9hOPNvDA6EcIWTiQ",154,322,315,637,50.55
"HotEboyXerathTv","foIOLct9nbUIBWzUTX-nhPB5QU7LB8c8X6pkJaZ_efpN1SM",95,232,227,459,50.54
"way to go","s8qR4TxDlknZ-FHzOTD4DiIuLh_5plG0EBFa_eef_iZQMapjw_XxsYutrg",43,47,46,93,50.54
"YUNOHANA","qKoIfrA2GA8qVhJdtN465tLzrZ0zBLJFJ-WeHKW5xmHhBJQ",1,281,275,556,50.54
"Jerrel","T5y_nc2lKTIXkCGH1M7pyEz35T3KtikKCoXFTOgpKroxDfY",330,511,500,1011,50.54
"ButtFrick","PXXc7ZIHcwAZT0BOYJm1sn_hx_1CwMIMywAQm2W2OdeQq6o",38,239,234,473,50.53
"Akrei","fPttHGAoOXqJiU4jS695YEFZDWxCPatq5AvYLHYvG4MplPXE",95,238,233,471,50.53
"Desiruo","SE2C3rBPfdmJnQO3XlnwHC_87wYOFyfh_Wld01Rbr-z71Dc",119,96,94,190,50.53
"Kouketeador","jFS46-LieflH0i5eGANTKUNaoGaVX8jc-J22aBVHNh7LEvE",328,387,379,766,50.52
"Anomander rakeD","0q4xKL8Dc8VZUgdSxqf1ejwtC7KeiPRaCYdJAMJJztyBSG4",137,196,192,388,50.52
"PressTabandTHINK","S0WEgqqe9UjU1Pqj5JGO2MF60Iz1LbxpmxKcU1h39-ppInw",259,727,712,1439,50.52
"Frog Maw","ZHGxIPULlW0mZDUZdU8593PhkYE_MbEGivno4tKMKcDx1WI",386,587,575,1162,50.52
"Amrr","4y6KefBr2kQ6V5-yydwSbeGhS34tCKqQfQBh0quHwxtYS4g",165,293,287,580,50.52
"RAMbo10","FLMKdctg6kT0I4cl8xgtw7snqhL_065APZAG69H-ufx12Vg",17,438,429,867,50.52
"ZSultanZ","Vym7_sudEoy2vWGFYXrKmnKVS0IhT46PT6-R59wmUUS-LZXZ",214,196,192,388,50.52
"Wunderful","LF90gGJ-5sjmPgjUdlKp03_jwZ1RoaS5Gi4Fbr_OT9XHF4Y",1,145,142,287,50.52
"monkey30000","V2ufIF6OXKpYqXsdGtsCURdizc1chSUj2jtivI2YmR0iIfc",16,246,241,487,50.51
"Suna Shogun Sama","BWpvE97904ppDuHaVxS4JspwkYt23ncMwdhwVVG3AINVoMI",1,99,97,196,50.51
"Repent","Lme8c_yvzxKKUo98ffjWRKuSMYQGqXbrmAC0P4jnsVAPIOc",73,149,146,295,50.51
"play better","5joSYvzzMAaluxdDGHJWMEj6eYfPVG2lPAsls5qH0Yqa2-w",246,297,291,588,50.51
"SentientAI","KqkpWW9KJ3-I6j9QLd-HOYjWe2E6gi2D1QU4vpL8cXM",340,250,245,495,50.51
"suhanshhh","QFjIszfPZnoJc63TUol_AGjuNVmdAIklMvbpxpvKQ4HwZlY",6,504,494,998,50.50
"NotAZ","mNoX6YTd37wLEI_fm-__J3SWAvNFq7pJ9UflFeYkBSBG9_yA",127,202,198,400,50.50
"look gogo","FbbbQdX4dkJ9d4rqI7R_l4wz2cYiXCXWIbepxqQLxeeBSPw",54,651,638,1289,50.50
"Ðewey","VYhnyOd9xDpWvWaKrtTwfb5Iiguy-5hM933tbbRdn4w_wmE",5,712,698,1410,50.50
"Sándm","wSoe9wZP5xk352etUx2wKToPSa5X0isX5i2Lc-8d1S3z6aQ",1,305,299,604,50.50
"Reckza","4oTDmLBxP72Jcjspxar3yHunKiZPUazOLt2o0_IrHsUR5uI",267,101,99,200,50.50
"Motelles","x13udbkM1IQ_f9GIWd7_kJVALqDDK_1EmRLd8wqI6o-7isc",77,152,149,301,50.50
"paige","iy-sBKGWkAnUEQSCTO1iZNoTtKm77U8ovj8eRANdJVL5nR8",140,451,442,893,50.50
"NoOneHadThisName","2OqSW7EBsXO4mwnWVM5t9UMBI0O8uMEanjoA0SIGg6jqIdk",438,353,346,699,50.50
"Huntervault","T2tfA21Y_HzXbwQGHyFGC_j9T4ZHO3xrmwsf07vj3awU148",1,412,404,816,50.49
"TheSkyfallsforme","cq8gXOqA2YsqOgRABIxZMHjhu0D4IcHM_KVB_pjt45ekT3CQ4EgK1v6TOA",381,572,561,1133,50.49
"Nostalgia Lee","a0g8FKh3utAUvLfEvfOV3YM0v-agvynyjDqmK9_FAgT7jt79A1ezKl0fXg",109,416,408,824,50.49
"avatarkai","4bCYalARAODcAXl2Uc6FGY57MXdXzjVVE6Fdk6zs9MgAo2M",38,519,509,1028,50.49
"Nanjingwaiguoyu","uc3bBEY0FAOP0ttOWRSpj7fvwFPvBZ3tnU-3uMsMXA006-C4EGv4JCrosQ",164,158,155,313,50.48
"Ekkoº","6PIaj2ZsUQWrUFuHSA0ghpVJWYT-RA6G66WmUAPTlrf5F1vQzL28S2C9IQ",106,315,309,624,50.48
"DUHBESTKILLER","WSo_aHPXgtbd5PBq0tCUnsoNUwfAQdCpClazIMUOSWjvtDg",239,897,880,1777,50.48
"Psycho Wand","Lm4ADRD6v5PLSZFqU_a48vTkJpCC44kye5lcZPIFTRrSZrE",291,427,419,846,50.47
"ı am","MulNUPa7Kls6qErKBWBNJ8zFo5W3LaoQsGAejfTeKQJ9NhM",409,432,424,856,50.47
"terryta","l2ci958dsQJ4lME4F7tZ3_uJGma7cVXOPTPzAzqF_FR8zHk",12,54,53,107,50.47
"Explained","F2hUQOcKHt3QEFCINPmPB_-r8tmNd9cz0aKYmzlDsB8Zv3k",201,497,488,985,50.46
"FENG ZHUA","t-aCDsVY49y5FD9p2W1LnXmy9OINciMt3gtoqCZhq7Ims2U",246,553,543,1096,50.46
"Euya","565cDFyEqhv5oZixGhos1Qj6Xiv46UaBwRQgp_wPViiqWqg",324,706,693,1399,50.46
"Call Me Z","4AfeqKAjEBAMCwupGw1Ia_2YCD1nusFR2qi97YlkPkYeMtY",36,778,764,1542,50.45
"Lust for Mx","pAwDgC0_gyT8pN9iw3-UtJn8P_oeBi3vmEVWZgURlcEBA4A",20,224,220,444,50.45
"I Qing Feng I","htkejnnDRJKOHM7n4AIpopMmcKVhOna3AzABMvjnmLGGlxs",16,445,437,882,50.45
"lint laugh love","BPm9FjkPwTBwAatZ3ha9-TtST4kPt_lLZY_0kUydmczCFV9Y",199,168,165,333,50.45
"Scyrnn","2Wy3VDZHRG92Acw6qHnt0W-jJyPMQzaMZpnTph05vL9tdTY",453,728,715,1443,50.45
"Adjacent Lamp","rfhsx3CNBcGwnCNX9o2fjnu5UZsHNXpSM6dysuKAZf2HlCs",94,900,884,1784,50.45
"Ramen Bear","57OLST1XQY8RK44J-OFz9dkemTeNENLVHN3VqEpwri8gzfE",46,289,284,573,50.44
"FirstTimeCaitlyn","1KQMMVzzmymKDYVWGTz70uIPpog362cLbru8jvM9FqTQjb0",275,173,170,343,50.44
"iSkaarly","S01VcQdjfix2Ong5cv3fVNk9-mdXTQakoxZMw7THvoWd9wU",278,172,169,341,50.44
"The Doll","LT7hbfIG_kDgvFKeqMniDHBHaQGqIhdyx_8DhLbBj8QBLNM",6,1094,1075,2169,50.44
"TECHNO SONA","R1NgVYwXI0W-sd3HWcrLQ5VBKWhSvf9g5pJ2RjOTVgjstYuR",185,284,279,563,50.44
"Dongeritis","W_dShko5_bh02fSvysYTj_0gRBygA_PUiDwomOsbBTGrpMs",115,232,228,460,50.43
"Yuki","UQFMik3Zfd7FykRNxYXlGh4JhS_PqZHtZys01e3ynX0l8fI",110,118,116,234,50.43
"Samuel Kim ","SBT-z6eejJ3TWE7HEIgg2RYz_9_qEVvAkQd5xom34zHr",242,464,456,920,50.43
"specific","MELSA3-Yi2XKTX9Ql3nER3t8h8GoDF3r060FHEAOSlamlJFm8w-Vm2lHbw",447,592,582,1174,50.43
"Aspen","70woDRPNya-hymu5bY_msboD2iCQNRhnQHOanmArL8sViGo",230,643,632,1275,50.43
"ROCKER OF WORLDS","YfjLP9q5r1or7ofBl8uTdO62onjn89CENuXx0g9KPwk-V3k",50,417,410,827,50.42
"MOB SIAB ","v5nQMWQh2t9g0pFHXvzaaVloFwXQcWvl34LPPZhVvzLbAiBWWI_WXgLCdg",317,179,176,355,50.42
"Riot King Cobra","zAAIMCUc1EB2WtB3fEaGqcYvKg6pW1NOrS-itfWUYZIkZgQ",125,241,237,478,50.42
"Kill1ingGod","3CZeFIKuJjiEk3FGz6FdYlV33A1KvbKb-iEpRbYo6wlB45k",136,244,240,484,50.41
"Deathcounter","p-uHpaYIX45Ko2g7YsWTY_cwwsGBvG386TeLEUdwXpJOJQE",297,863,849,1712,50.41
"khaii","UKPpE0aDjGQD6r8PX1dTKPePSFotYNzymJKisAW93I-SEa54",305,553,544,1097,50.41
"Annie Bot","0qD4Q3nbJX4lKm1WCnGfRkCmdC6ypWGTrAQJf02rO6vRd7M",428,803,790,1593,50.41
"Shes Super Tight","ZF7jIMKMD6OEjtPb2LTF56t8zc2klbofxW-B4Lq3nzaz2R4",244,184,181,365,50.41
"Šhiro","ldh5XZ1oR2nAMb4viX2xW8IBpVvNthU8bfdWGzNBthyzK3Q",80,183,180,363,50.41
"riversided","4cvQxI4f4_l854WjdoO8IdSZw472r1_07oE3xODWqNFbICc",429,806,793,1599,50.41
"delusionaldogs","8Ge2xp_QlAE-wTvUF_xQumYvk2e3i55JfLaUxDldEKT1l7c",0,183,180,363,50.41
"Lebanese","pc5tpM_OSFc5U2oux25qH3ZqEuj2x1_e9NoAXO9zSYvf7UE",26,489,481,970,50.41
"AFS kiin","vD8xNGQnA_PYekOu31N3NDpIGBB5JzLDIAp0lxW04Tp0AHs",166,434,427,861,50.41
"DisappearX","X2Ulnh--7rXDWLU5x0ee3pJe8Hcz15JgZm8nxuCDZLXKxZ2GQ55Y9UOwBQ",24,382,376,758,50.40
"Cidez","GbK9qs3uAfSMzcNzpd--j-VMGfmqIWO2g6EuHCxfepXaqBE",86,624,614,1238,50.40
"Euphorian","u258UJOl1ZBYJQdUWkJx4WOyAH3kfDldURAiAJHP_xaD5iY",48,251,247,498,50.40
"ill will","jPtErmRPjgbn1FM8xHETH628UdAaSw7UH6U2jj2VT7QOYVZ5",34,125,123,248,50.40
"Twuck","TvT5Z0ehQCBZYNI-aY1_cjj0dn5xFj4wFMQ-6o1FEC5LeWM",51,437,430,867,50.40
"Cinnamon Jouster","oueC0AzN0u6wWP-uXzD8Cp3G-hDM2ti_hzK8clYNgZE7Siw",302,1017,1001,2018,50.40
"Satøru Gøjo","5hN4Ka8Y_NP2Y8LBYJBb4OsQEUtWU06zeOTG3sNc7uKsFExfvajzdKyJVQ",211,188,185,373,50.40
"CallMeTristesse","D9HRvgLU_P5AyNZsf3_Q7YW0L1e1xcAx1kE6FDREgKKOyI0ysSGCCofZKA",462,128,126,254,50.39
"Puppeh","nVaelxw0VKoltiCm-Boxt7mCgF-MHKgv68OCcVBLocHTkYs",89,321,316,637,50.39
"Real Uzi","89BsBs5jS7CSDuK5tW00EtK3vmNc_-v6L22WYoijiYRVfBs",271,385,379,764,50.39
"SAtaarcoeny3","g6R2drA0JJe6IZ3npiZ9VLyJT7iWPeyLdyd3LvACr4CGsV0Q",1,650,640,1290,50.39
"Sym","H6rRSLuFBIFPz_x3jDWEyrbUA6qXribigULNOkckNqEk4ms",32,320,315,635,50.39
"Moonlight5","3vFTz-u-Ch4Po4g50DZbqn3A4hJfVztApEBv8Yk4QLNTlFk",205,582,573,1155,50.39
"Lusol","JTEf2ltNR-xvOSwcX1D_mMX7KdPD248u3Q9FixFQagANrpM",239,518,510,1028,50.39
"existence top","k-u2yDanrQnSX74v2Z_d9lDxuMI2CELhkYWLvuF_Xt7Dv7E",384,638,628,1266,50.39
"Shenco","nVAfRyKBKP6h-7SV2KIT3fqxlhniUotHvDRJCE-UJlVSNVJa",105,979,964,1943,50.39
"is my dear","rFhfXSJ5-CtUcp9ulkaFDvDMHSuHLPCAdbf6cft9NikuRg0",194,268,264,532,50.38
"Girlfriend Buff","zguyJIUqX0R73zlRWwlb9FqFQJ3bCO3siHwtcTiJWd9fOobamNpNCRdQ5w",351,335,330,665,50.38
"Stephen M Ross","-6nsRKYoiYvuN-AsjZbIMuP-WMwN-yKXEbbOFoCYYJwnoGsf",351,525,517,1042,50.38
"Gu Lou Dajie","oerp1j56ZhJxDmtRkWGpBZnTVGzisYZ7N9l7fT8ubiH8CXyw",0,204,201,405,50.37
"Princess Mico","ayn3ocF4ss95icRYwWHDaq9shFpsQg-l4sYxmWWRY0WIaG8",262,205,202,407,50.37
"Prosperous Cat 2","derb_ksP9kRqiXEGcDRInslHNzKTFDLslFnoanWlRZgQtNY",237,136,134,270,50.37
"KarthHecDianaRek","uACoL0hK6iy4hf6VxoxUnOA43dWoTgu44UeFjF0PZxq87TUO",154,486,479,965,50.36
"Alamander","WT2lPYb0fdLMUlqHBfkC32coDDsvvoTSF_iWPZCl4pLI",386,552,544,1096,50.36
"FGNERF2010","sspl4Ig9H4JzVQVFTPY72F1EOCrprSKbnceqfFB8iAGEkWg",264,424,418,842,50.36
"Suito","tggy3gS7toVdcvWTlZCK4aP8lk86ecVWjuHKOc2ocoI1xgg",84,425,419,844,50.36
"Zorian","pwfI9r7kcuihJ8WUyYID23OEa4sl8gTwK6FUL81t0jt0mEM",176,278,274,552,50.36
"Nykthos","M1pEyexEXacsJuIaHCiJ416ezmkAXwDafg-Gk9-UVbT5Qh0",93,1036,1021,2057,50.36
"Twocutz","bnFVAlzAjkPw42iJh0B43CJ22XreFKb37eTA3pemzaoRlNc",185,143,141,284,50.35
"whober","S3sqnldmhahsB8S1jfHVYHyqqMJHGPm3PivHqJgdR7WDS5Q",55,286,282,568,50.35
"Daimonz2","HohhmnX6_wt71xvAIxzSC-FcEghsD7p-lTc1Rx7QfjvhPXCt",422,509,502,1011,50.35
"TuLuyenThanhThan","Qq4dJNWwVGJRV-f7peiydr-2BGqDlxP5fnSBaxQ4A4FLmJonoOGlrOpnoA",62,1143,1127,2270,50.35
"wetandjuicy","hEEHdP_iVvBdC7htfdP25huyG6vFHCOOvq7_O7gxxJ6C3Dw",1,375,370,745,50.34
"ICUKAT","YdUeXlYRGKJo1jdeouZSXcdQ6oG9lpYhFu5qUUUCIeGy4L8",77,371,366,737,50.34
"bigfatlp","zU7PgK-cUfDwodu3EVqifMLlA7DseL7SueldHGl8kA",57,225,222,447,50.34
"30318190404","RMvR2f3_C28-5NHgRpxZWiT0QDIjQm-LfqjGIcafNP24dCQH9mW5Dvj_2A",5,154,152,306,50.33
"xamexxelpro","LYyP-_yEsMX5Kd2ldtJfGOWZkQvsLQS_E1OxK8ezsuHHZqk",88,460,454,914,50.33
"Zfrt01","rJa9xWjvl32plGNLIzbwWo19s-NrKdM5oiRwkBliDCGuh0w",32,309,305,614,50.33
"Kayn99","4g-Lh0ArtKtHxD0fDluK0EY4_SXn0_glGqcN2Ug9qbPmg0jw",405,152,150,302,50.33
"Likable","FbBLrhxC7fkyNyqH19XT881plQgwPNmokXUw0hPbxkqYtbg",316,684,675,1359,50.33
"Hoorah","U4-2RZe4Bsh30aREOaasdWR6GaplKbJ8cHPzjfiqUKFfZc0E",4,153,151,304,50.33
"Rositajonez","GOBfQWHbwwN1dIpWCp15Za3YbzZ4YsLB4Yqgv5xGCKjE2b8",293,316,312,628,50.32
"Bánh Mì xD","gFC7-HX-X1NxeosUZfu9Nz9FNJ67Vor2PRataJ9RIMpaVBs",363,542,535,1077,50.32
"sandals enjoyer","O1ZtE1PcWb2rX9sVeHvjUN8LN-ojYu4VKdpgljvRwv_yloWP",225,479,473,952,50.32
"Masters Man Pan","o3epE-lbZNE-Fr3-qyvW9-5JXv57yM0j9S2TIKXX-LebxAU",84,409,404,813,50.31
"Clareetz1","9qReK9jCa2S_tA5gwRkBy9MJMUCFY8fSHRRjE76pmvnP1XfZIt-QMkBlPg",215,241,238,479,50.31
"kiwi best fruit","SlKAMXDW9AyG1dsEivEwRpJNHliDVYzqfYfaE8v4toRqUuzIVVJdHO2rbQ",219,164,162,326,50.31
"BlackDog9","lqDvU16fv5COUXm7QcnzEjxLPPrk1G1O_W-z7ttuI5YzqVw",202,410,405,815,50.31
"Basik","2gq07u6fqccxF9qbyNC20TLtQaVuHtzM0A07ism_gE5Pigw",44,338,334,672,50.30
"Lokidosi","ypwUufSCdIQlQrMAfCk7M0Cq-aWaUzCluIhw5QMbFxPpX_Y",232,418,413,831,50.30
"LevelNumberNine","KNRAzmGDFzw3d57qeCOaWhcaGEd0zjZjEcj-4ndLt5XMkg6n",244,253,250,503,50.30
"Please Kiss Me","Bl92-IDEC35k7DRBWqZzS7kI37D8SnRM6lL_YmYCPIZ_cGA",338,251,248,499,50.30
"Notorious Malli","MdW-bH0liI_RlxJGukE0HUj8I8dZQCRqfUFYD8ekkj1cMWk",342,340,336,676,50.30
"SageWabe","iGgg3piNvkzOMtKemLejQS2jXJljtW1Zl75jqepI_HeLG_M",167,582,575,1157,50.30
"Mattkan","QXQZhU8QNqI-hr5rd1Q9hNKrtbhd_b3gf8pjTz0VRSeJ5-U",288,751,742,1493,50.30
"Dawiid","2VP1J7GPVXFsDC10kvrjWNhi-0YZZfQtMcm6ueIiSQq2IhI",160,262,259,521,50.29
"U K","woCIL4Iq2vIiaBkAXsN74fBZ6OSC_QaGrJvnQZHzxTMH5YG-gqdHpGTJkg",281,601,594,1195,50.29
"Doctor Yas","LPoGSlgJje1B5yVVNnZiFB87jmTGV7YeeBpDSR9vGXvjZe4",111,428,423,851,50.29
"EgoSlinger","v_pT5IFvs2DX0Nfsyv5T17bE4O-ItMkaE8_nnFnfgc86Upw",205,256,253,509,50.29
"emo catgirl","QpQrxKSkZmIaihx6a8svm_yoi6xpQqmN4Qt2P4RG29sjzaw",33,174,172,346,50.29
"Dedasesne","i-E_DndeMGxy2EYWBALrfxAdb1HrzHm9XYN33Z8xyjIRS28",124,262,259,521,50.29
"ShadowYosejus","uNIW-3MW-TDe5EfY0LvUwGRZBhp3NUUfsmu0Q18glkTZQoU",155,697,689,1386,50.29
"Shadow Master ","-8maSNq3s3EvSID9Bnvu67uo6PdQWfWKLZ7TF8NZiwIUlgc",287,267,264,531,50.28
"The plan is me","cjdekv3_gOLLyDGh4zWHD58I1B3v2oV-GzajyF-LussBBaMCkTkP-G2pvA",238,273,270,543,50.28
"Bruds","ZHMnfKW48wqN0U08aCmeaEl52pltY98s5HMN8JdOdLxF6dM",350,455,450,905,50.28
"Na 1etme","1-GiaI7tsgD0z5wyfOuYiMg7oO-emD-Jcb9BbcQ9gftTQp4",1,90,89,179,50.28
"ThunderQueef","E6ScJ8JaS1kZrgDUoorm3bILYg-D0EGPcs5oIecaMlWYUNE",56,267,264,531,50.28
"NonÉxistence","dH_rCIep8g0tFwZprAZuNzeFbZDB6vSF-tK83bjU6Kc8sH0",19,93,92,185,50.27
"shadowwada","cOGrpFylk9SNj_k5LawSmt8m-bFHHYQqlK5JJkSixQmR",29,945,935,1880,50.27
"sico","GEMJXEjD-Wovz1SaMbiCmaOFgLBBqeTovJX5MRbNB0l0flY",248,183,181,364,50.27
"ritorexha","xOOcsLR-5mFyk0jxxcziHGsuBhRez195oifIcxU9-U8Ig_o",3,470,465,935,50.27
"Around","2GAaujbecbDbuwGaegC7YPPcAbEV95T3UZw8W1dN_DgFpec",16,183,181,364,50.27
"Juke Jouster","706hxwaKHnmlm848K2ooxRP6ElK9R0e-Ft612oWGsDr7uBMO",114,379,375,754,50.27
"Móíst","Qe7TeNl46Q43IvNO4bv275ICVtszPAn8cIVOWOuXL9pQ8x0",229,370,366,736,50.27
"The XXXerath","20Q7cjWcbrvRbuskEnR-lGpQbn58MI2-kYQEzjtk-waCCjg",332,97,96,193,50.26
"Hakai1","NO7MXFxi3kO5oOAlTZxo7fMLdb9wl7xNpj7XNAgK45Rr5SI",331,667,660,1327,50.26
"vampire queen","r9NkPY5dc-q_nDAE_6h2k3tIMLQ1twN29rXNxN5CKvYNVmlv",99,382,378,760,50.26
"freeezelol","NDYzurr2vJ-MGJc4XaNCNxYAEAnBuN9XK_sWlGy7m0ccFuM",48,305,302,607,50.25
"Nappy","5vJmJSXxtQmF6rS2IhOK52dLguUBP9gRuUnGto3QCqEvs0w",179,203,201,404,50.25
"Stevenatør","2bT55xV0hqMMtw-L39Ugx7sPpCEMknYg8kCn5ucvjgrhjEE",378,401,397,798,50.25
"TornadoWatch","Ny51a5Oh4rkJFbsrQlbHuQ-reW8gPWsyoyOBVqxlM_H9Oxs",125,1057,1047,2104,50.24
"Mephistopheles","5qpitJlULNLAN-ytqwXB9YOsIYW9jwBZyeOeZmpRNPhXVE0",176,531,526,1057,50.24
"TL Honda Bradley","8CYvHcUv0r-kroUK7IvhXwYr6scmbW-j_t8LELvlhz6iPv4",307,104,103,207,50.24
"Noìsy","kflMNbDJpHvyxe_VpGi4YizJYU6UpQbj8oMBEqIq9Btc8-U",16,530,525,1055,50.24
"Quantum","Ubg3w3Mg4UOwtxCcTKqZ4321X-I9dQ7Twsi00-CnafZFmMs",453,634,628,1262,50.24
"Darvec","i8BTnqzjezF6tELmx-e8kv8SIU6SZTQPiF_N51FqZq5CMig",117,513,508,1021,50.24
"AatREuS","UL4uENRTA2oYAYhF7cZ6KD6BOcBSYLwkNGWjzK1D_UoHzEY",169,761,754,1515,50.23
"Firebringer","gDs4sq6kEoMEJ7Swm7V1utLI-IW120jAv7Ne_YgGNn62Axg",1,218,216,434,50.23
"Setije","fe4Rl1OgO8r4p4wZOXWqUQXJ6FSW4O3axXnrNF0TUee6Z9I",200,431,427,858,50.23
"Small Fluffy Cat","YYGrfkoGQJlJGV5UK4V9gW5yldmHasygrVF39qUkQyJfde4",53,332,329,661,50.23
"Raveydemon","ZECbFVOSD5ZVWzeYEHwLcHuS6Pit2RXp3gD3s4wQ0Tj4Neo",338,666,660,1326,50.23
"Hi Im Famous","YImkgQNuh1pDPA5zIZNer5AWA27OyGxcOs0L3gl41DGI9Mo",100,321,318,639,50.23
"Plizak","Ehs5MGj88Ang2cqkHRZLEuK7KhIimHgEl6YitkdTHO5sM18",354,445,441,886,50.23
"Titan Dweevil","dsuA1yF4avKX3JVZNc9cIw9UfxOeqeJYMj5JnHCGkVcMiyU",346,442,438,880,50.23
"Albedo is so bad","CqGeoZVLJBmx2TWaMkFz8HqOV3yG8KgxIr7RnmLYfKslPUc",1,109,108,217,50.23
"KTiny","cYQ1qQc_AN9RWzPXbmO3AI9L_Rk0hZBViG9MiDMVVSFP3Yc",1,220,218,438,50.23
"Fiction","YXd6-grfc5Dp5c7foMfG8KusFeO03mBw4FBrc4WTCBbbgdk",468,657,651,1308,50.23
"ethankcheung","4_N29h0I9DxxLRkczjScyZwYiXxBM74fdPfiZRpKpFDp1Iw",247,215,213,428,50.23
"Y L","_IFSu0x54oT2erHh0YMpycXtwcGSnxcfe3SJY7JitND4L_E",134,220,218,438,50.23
"Why am l Bad","u6wkZCx5T1zIoUTTK69vF3HeWhqFVB3URhDIRf3dshaJ4qo",410,984,975,1959,50.23
"Peach Soju","ivjQK_DBOE1WOcf2juVsr9Gd2kKumj7ChskndQeH2zaDR2k",241,335,332,667,50.22
"Ontario Steve","VkbSdW0btC84C8Y0Gq9PrgW6rzFRSV_fy-g7hRYSkUd-gjY",100,457,453,910,50.22
"Paragxn","aNwCUFZ9bZ9W8AEXssVbVpW4Kc1wT2iyY3IZp2rnAQAhJbA",129,571,566,1137,50.22
"TheePope","nREKL3gRRM3dNmbsJkyTUevm5srJJQ13g2fo0wHkWK2dwvA",184,350,347,697,50.22
"Kolthro","JBwXNTDgk-_TKFDe2GbSACrvPUPmIgoLlGFhhIUexqkgnzE",285,336,333,669,50.22
"pzzzangs student","DeNf8zX5XunZGmjP5Z1MbQ0z46Y6Wrag0nuWmt9-WosKELs",134,1346,1334,2680,50.22
"DeadIy","yGlaeycHoRxmgwz-znUQ7hjija36vLKtcxfOTILE85VI1iiuBWl1gRZBcA",208,227,225,452,50.22
"ShiroJoJo","oG5ok_sCUBttCHCDUhwUzhG5TCm0ABBYUU-LavyykzESAwM",1,339,336,675,50.22
"William Scott","JzOJYITZP_t65WsDqft2fuAxEyK8FGtrVdRFr-6tb-XvgxY",131,567,562,1129,50.22
"Warlord Towel","IFgd56fHJIPKwOvTPb5Xh3N2E2m3eoxXlm0ouvngbbX-6ys",160,233,231,464,50.22
"Evil White Man","tzNGOVPBZ6T8jqSNIfJgTTNEoyowEAiAv3RkgZ1GCdVNLDg",1,116,115,231,50.22
"classiq","xicbOxhGRLIS_Mh3HJS2mifOSpOADVoYpkxDFShjNH-oktk",375,572,567,1139,50.22
"Michael ZSE","H6dVGJYPK3xJY1CkD9kD5-vTVoNZJH-7C1BNBF1b2G2qGgw",29,448,444,892,50.22
"KiteAzure","e9jfRNNAAISY6cKMHxsaOMJtkhY7h_fOQ2nzplOfqdzpDDw",144,226,224,450,50.22
"danielrmc iwnl","wBK0nK98id81ilN-rgjdEo6qF72hVnqtsfGmYOanboT1uD4",122,112,111,223,50.22
"Mercurial","MFqB1EZ34disBkwV3os3MW6yoWahVJr0cqZ-qiat1FGhqho",227,594,589,1183,50.21
"PetaIs for Armor","RIdBDV3tehtxDUkIsK_tFzMaqooQfIMo8s-nZpsB0WC4R5Y",267,585,580,1165,50.21
"wo si le","PdZeRYh8Kl6mjXv3tL4sQjkLvkkwS33r9YjbnmEC58FPXxE",97,117,116,233,50.21
"Dinkey","Usifd9VDnHixHbcw85B0IusKwoaCo14RmVhEcD873hSMjOo",94,585,580,1165,50.21
"DrCalculus","3SmWQC2zwdq9i13W_ELe37xTLjd3fp3WWEx1S2wW4HBeCZ4",187,357,354,711,50.21
"The First Poro","uLLHG3lZsaWgZ5Ro-8Hv5bIv5sZl6PhxRNEDIzL88nQ-3v0",73,488,484,972,50.21
"sssexy princess","2sZ30Le_NV6-06jlqPYk28mnxeBOjOqNOoHHh-wTiGoflgVh",26,122,121,243,50.21
"ovovoovovo","ZrOAvHt7ShEh8MIWAJUfinhBZhoeszpNqdKWGPpNshH3Q0jN2Cbh3qCnYQ",296,123,122,245,50.20
"Beangate","s3Baa8IkjywVcawOOpyqsYQzVu7SaxdlbCIIreJLjZ1AkbM",27,506,502,1008,50.20
"Veiga","VoM2C6eyoWl2JG4JN_-YsrRY4WO9zBD5d1MWHFTyUhF3av8",122,383,380,763,50.20
"CIøuds","pO_OgBX1Y2vIsg4o-dlMRT57Egj8yfiXGr4lTde9jY3JB7r1hPcs2Bb9rw",144,642,637,1279,50.20
"Pułverize","9XbvNRHKG3_SQOb_77K8LN7FrM-Fnyu5X_7JpHzxhwt6zqOC_r1jPrlRWg",30,255,253,508,50.20
"Abhinav","6pqKZUzlP0S314M21LPxtp5AKwLzIucVEmWyHig9BPV97iU",67,131,130,261,50.19
"sword niuniu","3JWwxxkQvQQBWoyC7gVAjah9QDexbpcEYD8Jw4FXrUsOxNA",77,262,260,522,50.19
"TTizzle830","XaUxN7FY8uus8m09eAWC_PuCTYeTcyZdmkMWdT8-0PidN-I",192,131,130,261,50.19
"Betrayal Stings","mYBsaDU0Y0468ra7ejVGqqU45Z-jSDJX8z7UgBeWlSnzkEly",145,263,261,524,50.19
"DukeTed","0hs0dBd9fEcvasAWSkMqYH8w-KwcF6TgbNPmJZSfNV2HljaQ",181,537,533,1070,50.19
"Arâ","7BM4TGzdXplg5CTTrh8T3n7X6IZSUDI_vqxr_svBqYRjCSE",58,281,279,560,50.18
"Arkam19","G_NepGm4Nx81IfoLJJDYPRqjGirHS1QWicxsBooStlZuGGE",199,562,558,1120,50.18
"LostMyM1nd","RngbzXvprG0pT37qGOvaCEI8qcO9i6vVmx5BaIrt5CF37OA",159,273,271,544,50.18
"Senpai Neko","CBRhhNayqphUNPcTdWDHs6qe_Wz5UuLFxB9L-SsOuYvwLp8",16,553,549,1102,50.18
"Chicken LittIe","PYSXxf4iHc6Hy9yNFhQa8Z7MFwZbpwmS2XdnPMXo_5ItfxM",379,276,274,550,50.18
"Lua","jGgj2021jOvGu3uKU505o7Vwrx7KHmnGFoVOXVuSaDn_WNo",1,276,274,550,50.18
"Tzuyu Sana","W1qCrtnct5A1nJifp2YOqR-O4PeCEDDKn2quxso9ewNB0Yk",204,296,294,590,50.17
"Guxx7","TBrAiz9_nAapx2KE-brRusKrkxm6F3KouvSNFH26wVqY6ec",119,151,150,301,50.17
"Jokage029","70PTUIfIvX3nkAFxoSZnWdrnXqykcW8BNByqadRuLi0olpE",16,292,290,582,50.17
"lnvent","3agSECjILOpVkLB9qSB5HZnIzNrd9A1tHDpcIs2lB7tjjMej",160,144,143,287,50.17
"Arsh","uqW8zSNzm6cxSfMgYRrKVFvaavaipqy5fnaF2Xwm5ZSZI_A",185,295,293,588,50.17
"Axł","t-27ojPGm-1Y6NdjFfgWV21x8QtTcYvtqLIO7yKdaDqqlj4",35,446,443,889,50.17
"xExplosive","hc8112Mt_YZDZoWj8SQq4PesAc9lcBBVp0HJljpfhaU6Cfo",0,436,433,869,50.17
"ANTlDOTE","ruf1xxkD5pwVtHtVrk28yE4wuiE-mDoIJabf72dDRKmtzJE",67,144,143,287,50.17
"Skinless Ape","vlQJIWLWghhVpEbHL4MVtyPJr-jWfiRC-Fgu0nFZwYnhe20",162,321,319,640,50.16
"Avers","r9qa3uQsTxVJdpQ3oJDrGiYrEeKoy82Rjl_H9miLJTA_CrA",388,468,465,933,50.16
"Gawr Gura Nya","aAuUFRIZpyiZJYcHUZDpqiwhMHlFMCzFA-tp5F0RB4Ybk6jR",35,476,473,949,50.16
"richkery","v3_oOB-UUeWEqDX-WSZbLzZHZ-flMgIaJsPgZPK3K5RgyOQ",46,772,767,1539,50.16
"sparklol","U4enGhll0WpJYyK90FIue1O1JqrIPLfn6kwXeJ5lyuqtr-g",234,464,461,925,50.16
"VoidStar","bJPnUVuOa7eSBTEUUhYRgUEoznPij3fUkM74gLGJ1riIiiI",172,475,472,947,50.16
"Melyn","u7ZTAruhLtrFMMc9S4nko8JNNg--MgCS0IuJOyGPPRF_MjU",176,156,155,311,50.16
"missing Yx","qAGp63f8cwbg4rB9PvIgiIrRyVPEpJpAwPtyGv-KifO4PdEn",7,172,171,343,50.15
"YaaYeet","s1bl8AxihpAy06AOnhsiWRKwB1WyA2ouYIFpK8Qx4Cz43bmf",167,499,496,995,50.15
"Kilering","_FJ4eDGsUqHwzszL_ZlyM51-i2-aqlKUsqy4XrNmrM8Uif0",26,162,161,323,50.15
"schmuckledoo1634","_-jrDc9KR_zf-USQ698kNhkei1l0XE4Xzcb8IezDjho1ISk",435,333,331,664,50.15
"26331","Zfgb0xcxs5DSAj6A4GiwlpGqaew3RzJn8CYqGCSq2uveuooK",50,170,169,339,50.15
"Slim13","x1U6zSpj6auIiJjRuyb7iN4DIIMinOL0PECQsNX7LBYl04o",205,495,492,987,50.15
"FLABREZU","v1llhId2vmPr7uLsVhKAQyshcjoa6uuTBEZ1oAvQbDNQiHo",162,169,168,337,50.15
"WHENJUNHEN2XYDZP","ubzt6l9VPsqV5TDmR0DTvYnITaFcl824IAc5x4_fN452o2w",40,176,175,351,50.14
"MioMio","VAZcjK899C90OmRRiIbKuKIHqSFzOB1dc8vssaWJeSSlW20",18,174,173,347,50.14
"helianwu","dDbn_BRvLft4gwVRIPLOraKa5zvoVqEJXjK1LRMeQpI4IU8",0,347,345,692,50.14
"Plat Players Suc","2C4QanYigFww-Lxpzhn5VLIppbCGbQl2O0Bt105twcLXhp38",231,871,866,1737,50.14
"Obscuree","synMI0X89dfxIiVg68yO0sOY8QkE9vjC08QIoPypcggMmYI",197,190,189,379,50.13
"TugginNuts","WRwRbsNJQZk7e55DTaaNUW6mxYgtLQAm5_LIOfXhHcJh4rk",16,189,188,377,50.13
"kr4zykilla","U1um_zDPrF-X0vU95y46g6TPWCPS7M-UTDMCBctfHP2mBKI",65,375,373,748,50.13
"Eisuke","oq5_1BjEoiSl5XvsNIgoz28ETmhATWTys5_bUOuVX0BCzLU",180,572,569,1141,50.13
"Léo","aWA0fmyqpFnMHczXkaWx391wjaHSEPSBxeLCGsh-b83yANM",103,586,583,1169,50.13
"AnAfroDragon","tr0_XGG36mhKywZYKiIsFDVOsa7u5MbhjHD6zAYEgui-DPo",24,585,582,1167,50.13
"Nice Bunz","Q3mTaeK9GaIJi5Oaz2jUTJTBa7dpUwvSHgz5GRBXRNALnBg",164,191,190,381,50.13
"Empress Bee","Ne9U_0ELkvp5xsGzaj3QYScSv0kT8TD2oAJD7wb5qhUwsfI",174,592,589,1181,50.13
"Muwa","lsF6Hzafzb69bT9G-69KcJnzlJZzWnsur8SuUjx0Ht_lOakG",166,213,212,425,50.12
"Last Hit","f7R3N5bqCDqZUpEe97PVG0Zq-I_PtQu-3djr7olM7R0qu-c",198,210,209,419,50.12
"Tecto","Df7a7GEwvhbRvqOxtSyPYeNeIyrUia6E8uI08WTFiBA",1,204,203,407,50.12
"warhunter","2GSUSTbg61MB9zY4uCAqzn_IjckM_QdC1zPaZfZ_QcCQ0tE",277,207,206,413,50.12
"doogle999","8JBljRKsW1lM6oF6GPVc6EEMVziqdaMY8JCZxs-MgkKticOmcOrcIwb5bg",241,427,425,852,50.12
"The Zodiarch","3tYrPDUiUXttAfPXYgHmoRDV4KRXOl-sldqsMheXVf0aV8k",1,213,212,425,50.12
"stelllarStellaTV","Ah1kEuSn2NAn-k2PS5jjRtneRKnbIScHZ2aDc0zA4mXRAEOO",88,885,881,1766,50.11
"sea of cloud","B948HbHNKBEoBf4-hPSL8Cry8lRK3pmW87TVYMYS2Nxv7HI",154,234,233,467,50.11
"USAjj2","w1QaLZjBeIZy6E1t8OPEbri8V2-UHPSRhAWy6-EmM8u9obY",195,233,232,465,50.11
"lce Truck","ctk6FLbOh_nqXCnuWMF3CzkSTpXSABtDBTaBSPP7AJysVWg",198,261,260,521,50.10
"wff010","QY_GN_9n9sdq0SO_GmwZZfhfk_aRH0kBWEemSgu2GJx8CWo",225,525,523,1048,50.10
"Wine Cooler Mom","5gTbXzLxC6HDBojeXYPm_ez94iFuMOTvjBDYZ0LDcLlt5oA",161,289,288,577,50.09
"SavorWolf","FecE5gO70nnNXDKQUUhivEV8581Nlr-c9x_qgOTb5jaszJU",88,573,571,1144,50.09
"Mıchaeł","BHXyRs_Euhv83hof_jzK7UDIkWklhYiW5tJETJmX3ZdcU-E",120,270,269,539,50.09
"Nightz","wQbToqFnEUUi8QvSMnS6alS1epDAC0832Z23EEFuAc98mjk",55,810,807,1617,50.09
"Poptãrt","oojpzU0so4wD4rgvHi7Z_kreemDSvIedtEaZNiufivyUKfg",152,277,276,553,50.09
"Doowan","06-Aebm-R0YLl4nFgSEtoo8ese5j3OMDuxiROdkK1BjHvJg",0,284,283,567,50.09
"Chill Trav","Leb4JjV0cyvRi18y3wih_K75-QSP3kkPsYK1brjbI1N6qrrg_-0kuHoSog",1,331,330,661,50.08
"end credits","-01hVpEKyBs1H6nKGv8UMNDvWh46VQvf1AcaIbrJVI07E48",1,332,331,663,50.08
"Xbonexs","7m1WBbgNDDOd_xjr-ij271AdC_VpHWE-l7kQLB5CXB26BwA",161,1114,1111,2225,50.07
"Liquid Therapy ","08PeH066s3jl7CCmVJ_r4hHAsgH3OAf3j8eO6OifDc0doaE",0,359,358,717,50.07
"Odir","jOat2pdgCDiBooXqGtNOThdFzFWONeKCGXtsfWu2CQBOA_XB",187,383,382,765,50.07
"Prestıge","CZSsvIGWJMpW-xrojJJuIeRP6HDxChw-ld4ybILHu8XH1d4",100,408,407,815,50.06
"Bing Schilling","1cuFPdFcxzUncdKjWD0mLf9JM_-H4THtWt8jHS_Kr97r5jo",32,426,425,851,50.06
"Slamx","18Q4DA4Yt92kDhDNQqTPQjvDt3nxok3R2KxqXaXxh0K9sjk",108,443,442,885,50.06
"xWind","IEwDpiFNidaj8nCa9HrKlDSNdioN9-QIrEHgKOIBP6GgsMA",105,413,412,825,50.06
"Chaos Return","M_VVPgFEENDWjtN9hOvJ7x-Aylc2kIozVk1PdYoCm8Hc-sns",217,837,835,1672,50.06
"Archangel Aatrox","seagGCboI2_Z2uRGhMRvXj15qMEc4CRNb9PPWYRGX5zQnWQ",97,553,552,1105,50.05
"Midorima","oeYWybj492JzxRf5xAZoL90VYKlQSST5jLVqAaUzuMbWDpw",274,525,524,1049,50.05
"Rhite Wice","VtTGm1xgjoueJ6gDephrQDIZcVofZcaIqvragzxQcmHunCM",275,523,522,1045,50.05
"LlamaDemon","NTuhSRUNa4KvhrBpOnrtCdAFoSn5BAeZFc7Ix8jS4uzInDw",18,529,528,1057,50.05
"DOOFENSQUIRT","rNkTJBd2_I2yr0XLW-25lsJryK87Y2MrSGwIJ9bzJ7v1-lw",36,1020,1019,2039,50.02
"EnFlayte","LhrdOH09LCuvooRADXoxSZ5AwVlqY9Di6jP6N2YpvcRaNKI",7,64,64,128,50.00
"Kjartan","zZVXfG3_Ogjp9ZZGMSlzn9jO-dGLu8ypc-r6o_6DRQwWVRI",116,95,95,190,50.00
"ozkai47461","J6RTIwTFrVzNCCcFve2xYqyMksCj2n8HQEss--ZvJRxyLFc",284,273,273,546,50.00
"Trashuö","ObxhCFk8Ut0HfW5egDQdnToqTRQ_j0vQoc2ll7dakKv8CApa",172,711,711,1422,50.00
"Julian420","K7FMMi40CmZi6jrzU04lv7rDzHeeNF9EPIoQ0KuGwGDYCOo6JsK2H2imGw",87,84,84,168,50.00
"Navier","Zrqu-fILH2TRySzdSOnG7GW1wZ8TljWDWiIse9c8x43iI3_R",50,71,71,142,50.00
"Scafe","ZWtBrqlzq80khvV4NBeY7GAXVcyo6ZesvnOuocA5dohOrFM",115,293,293,586,50.00
"Mr Comet","m_qCkEn6XU31x4XNdkg8xcUWW7S4utGMJNQ_6o3VGSBpGAM",242,135,135,270,50.00
"Tow Mater Fanboy","iqtg9bNh4Bs1hO8zfdW83BO2rjiLyjj46WD3-6_hoCDuO5CO",41,56,56,112,50.00
"ASC Asylum","pBA4LaJ5uTkizB6o4inCdKubYByGIUyDODUPr3hLeemJ718",52,406,406,812,50.00
"Lord Kuzko ","lSaBO7fIViC9OJX25Jcjmjn6xJfQXIhyKMOaHQypciATdWY",181,459,459,918,50.00
"GPR","WlBXRnpehr1PzSoYRdRfihKcKfxQwAilpgGufsCbwiWONP8",1,199,199,398,50.00
"Molybdenum","orQAx52YYW1mA4S3iBnEfl0tILjM2qy2EPpE18wFCHjnAgam",2,350,350,700,50.00
"TheRayC","MW6IGC-HJ5Aseptq4QXmrNiBhQ8nh6fJ2x4ZfsawNFZJa4I",29,197,197,394,50.00
"bobqinDX","C-TGN8dWXoz9B4zDN8t-epXxkwLGIPUgAsrfSY7K7hWY0Q8",50,161,161,322,50.00
"Best Teemo N4","JYekUPygKSocm7tDl8T4K6zkfSCRqGKoGBVidR7p-uECeXE",16,319,319,638,50.00
"ShabaMoon","MjlsyvMXNwiurRIZyw6JfZ9RVCL5zl7ajANDKJaW6ycuEaU",126,176,176,352,50.00
"Yukinð","WIo_xYUvXyiW0SWx2oVy0j44-bjjLVtrGvCkSfsgMd9kfQs",207,384,384,768,50.00
"Inexhaustive","vkjl4i2z-Be2RMqir5DUF4u2fGkeqePe0oFt-46-VycObMY",105,169,169,338,50.00
"0asis","2IrKuM_VezMP2uKDVpqJllj1woITLg6OVFF3a0Vkc5kSgwk",32,199,199,398,50.00
"Sasiki OvO","9b-AHin1hDX2Sc7PY0Xt2lY7f3P-SU6RaRItUaBzpK3yRi8",312,209,209,418,50.00
"BYE Dopa","Z4VPRrPOCfBC2sy1kYCWsxVFO3nbta0bxr4H1ScRW7AuwAw",128,131,131,262,50.00
"ristewave","GLZSLjPAjrKeyJfy-CvalFfDSRc7BoKwN-9wWMxzGeO1UuI",81,171,171,342,50.00
"RANK 1 ONLY ","MFuWZg6S3K4Bz3Y7DoRbVbSh4M34Uc1d3y1-JSIzwZeVzrY",12,98,98,196,50.00
"ouoouo","_5T2U-0r-GmRsf8nvRyqVOYoTMTLQs0NSQDICPOJm7GVq1E",0,176,176,352,50.00
"KyungFeel","xszV1syHWjvhFdWo8plHhuYIwf3ClmqGbp8yIZ9cHqxCUv4",0,163,163,326,50.00
"Sassy","x-c6vT8V5taKXqAbAntL2Zb8zHJGxqnTwC3tODwuL_-PlAE",216,332,332,664,50.00
"ggez supp diff","t847rJA0W0BqN7Xavp_EduPGhZzo7rLlrTvOGExy7XiaoSEb",86,239,239,478,50.00
"Purklo","2s3fR186IpU0qtqvvrR3dMx9Lb7Ht6e8cjC4_iKONOUX3zI",28,252,252,504,50.00
"CG Skylinex","In8-fCuvktLoQ2uuMY1NVMV7NYmMYYGOrrryNCcUz2VbNwM",1,186,186,372,50.00
"ZHUGE LlANG","q_I43GM-Rzo7YcSJ9lz45AS3JYOE93oWjgT3uz0fXqiSJcM",176,198,198,396,50.00
"Bêr","YQte8-7Jjjj9cxFOWR7wALfCIY6dWAzbYiZAMKya2f-Co9oU",111,144,144,288,50.00
"OvOwOXD","OdkihOt6k_1Eqrf8zFTJu_XxLm-Bw6OA-cRut_Mhrlj5VaI",65,59,59,118,50.00
"Phushimi","ywyCnSG2caxdJ0iqv-PLOXfPridXxc0xOppc2NV1viKAYt4",89,134,134,268,50.00
"ßest Zac NA","FkgeuEjWgkeZkr_ekWLmnbyA99PdpuRuXNp3gsS47eOFkJlt",0,215,215,430,50.00
"Rënekton","laGgqaYrk78P36tNREWrvepYxMAHDoltfjffhVekgazGqlrj",266,181,181,362,50.00
"Clıt enjoyer","vWbwIUJjHzzTmr5GcosyEi7aQOWbKB_4qVVzFYzD38ckRoj_",18,253,253,506,50.00
"Thriven","nUvKYNV2LGkDyMTO4BDexQ0naYVdUCsRPrRec23CxvXCVjuRMyq8vQk14g",196,58,58,116,50.00
"Targamas Fanboy","aP-nEptnhKbaI6kRbzGvmPz1T6xIedZRdfD1BwK6bjL5BcUDYj16PZ-WQA",0,161,161,322,50.00
"my angel","HdSHzbcvXLY6adGdiMny-SQbbT2qCMxqgw2zbMjGEYn_GCk",0,251,251,502,50.00
"top gap","TL2xzXL3Hvv7ma7tLAJs-BGIXNdTCj3mhtwd_n_djkYGieJo",1,183,183,366,50.00
"l Clarity l","0_IYtQtNBqaA2PGUQeLCe8BuH8l2WM95IdQFuM55GOWP6VA",294,215,215,430,50.00
"Lil Nate","q_-mIZhJHkmqYYTpKy_V8vJ5HzpgH1uDEwcqsTLqmpN3l9E",23,91,91,182,50.00
"Chanban","B3eGUixQY5xWc1pLrW2b0iMD3n7x9Dg3KDyU5r1tZ4UsgYA",34,125,125,250,50.00
"NanaMomoLala","X2BfvNk8pISYq0Jg8Filr_-V1qAnIRS3fv_ThDL5wc2FJo4",329,438,438,876,50.00
"align my chakras","rIMlnxAFYpgmIslG3crq2D7xjB5zE-QV_ZHIfJmpzuayTl8",256,181,181,362,50.00
"Peng Yu Yan l","A8EJ5nLQD_asOX4a6D42OiLvXV4_XQ7oi5DvzJzZGRRkEHU",2,190,190,380,50.00
"MieeMieeMiee","3p6VYces9jQeth9p0gXoahgZEYuMlq1wD9qlGCRaARXRlOpP",1,297,297,594,50.00
"Tehpwner188","e2N7JmCDfg-JXtyUh6_fQcpL-phIQxY366BtSavudmV5RJM",145,281,281,562,50.00
"V1gorous1","4qy2pHHZSoLEbNyUOcp7HWAwQuqI_Zk0Gf1cXj-tvA-0Ih8",0,184,184,368,50.00
"Spladaddy","I4AZibIOTGwag5ig8jNezRWP6t7BqCzWCxcEAPvVvpfX9ls",126,708,708,1416,50.00
"anew07","Qq0ZR47bMFYObo_gQsDlQn39bUgaKiKgDAr3VvdRomcRrkY",111,686,686,1372,50.00
"Excentric","YamgV9-QEyUAx7M-b2FsSDBRLHTY8HfZqe1jye8_KdShyI0",16,130,130,260,50.00
"JaneIIe Pierzina","_i_tc2ggTQGJewH7qf03-Y04W-hbkNJAiSfLJG-BlGGSPD0",0,53,53,106,50.00
"Hypha","I7rUCLutN4Fs0uyI3bung66zr83nO90o4--kP6hxBV9vf6UR",420,257,257,514,50.00
"DiscoBoat","_iAr40htzwFuj6Su20Lkd-_cg2lhy5l8SthdG9h4H3A5_EI",20,46,46,92,50.00
"Wàrm","95UNEYOdIeA6INIjtaqr7Kb2f05xL58YjGZAHiPylQQiFT4",18,45,45,90,50.00
"Skarmori","dQAk7X2AAZTGQ9s6dlCYxCgi22BX650PBJSU9ZcLFKadwt0",1,83,83,166,50.00
"jimmykoi","vDPbAw7TUiu0SMh50AvBpmgrSQLVinUUIGRVWEsmvYw9Rio",92,105,105,210,50.00
"unhand thy lp","DhL2LetW8-MPoVN8Kp2BK95my06EpgNuwF9d5pHJtGG0uA8",1,188,188,376,50.00
"DorkLS","vwn8-vWnxRMJ26AyOhdt1-2FX1eRmobJCNnGgXLbjdRejzE",67,247,247,494,50.00
"Joff","sx6PeijsUEuBoIurCKZiH7dAhu7a-GEwE3tiCNKABHQgMDU",319,112,112,224,50.00
"The DirtySock","C9wMrLUamG-18YqGx0WY7O8JKTRZdXksM5qP5ErQImOSKrE",150,165,165,330,50.00
"Nemesis Prime","Vt8gflTtnXcC9aH_Lb2qZfLSWSWZa5vZOZd09YdwsETngeg",1,135,135,270,50.00
"CyanKip","V6srj2OLtsI8OLFK_czNCpY75x9_hhIiEUVVBQz3ZgS60gQ",104,456,457,913,49.95
"YZN","6_dciQn8PZjE4cU4J4cmkA0BwXi49_jy_wi03T5Op8CtI4h9gYDzmHq8uA",41,478,479,957,49.95
"Xinthus","AFNVOAqv-1_Qwr87QX78MdDVUz2NOwcqR9zSL5okN4faeT0",41,416,417,833,49.94
"awko tacos","1x__-QoBZfqMABHoiGfuLom3qzOp14Wjwt6KsGjJKL3r-SM",58,792,794,1586,49.94
"Riot GalaxySmash","NpOImkT4-LI2jmFkEDwhhH1WSLDp4mYRroQeZGxAhH-Sjt4",164,400,401,801,49.94
"Sex Defender 0 ","ZU7tCmnxSp4EhNepFkruxERlKmNxU4VaV5rZjD3MwaKFIM44",47,419,420,839,49.94
"Reform Under Rev","8bFohwX8pINNujwhE-ML5ZqmNOLre7dV6wvelqpZSWtmmcg",201,745,747,1492,49.93
"Mérthos","VjcSQ_-Eq-nlTleOhJISB2WtGL5jbfFOn1uHaEvVTYpxGlg",113,1071,1074,2145,49.93
"Pentius","G1NgfG_ktCtZ0FdihEd0FVGvfRXFUyiEhynMYBsLyoA7sMs",163,334,335,669,49.93
"suppkingzzz","VKdI4om4iZcMLVSWBI_G0XEtHg3HsQwGFG7eX3iUkVOpAr0",52,895,898,1793,49.92
"reAnchored","0mVfGbGPprXWqDafmR-ay3McIjWIWzqW-Da4EnEZRXWsSdo",95,619,621,1240,49.92
"5 seconds","ZS0thgDutIRIRkbww2816EXT0xXNJCubjK1V_IHz-fexqermwPqkGPoEWQ",32,296,297,593,49.92
"Hiccup1357","1OItFd1wk0LTSqr7QfY5BTEPTd1fLIKPz1D1wLhOvZOKknY",274,329,330,659,49.92
"Kammgefahr","wj4d1N6EG7PQKs4VDFWFGcH_WJ_6v8UysWAF5rZiaJvtcGg",0,296,297,593,49.92
"Joergerbomb","Dg78II9edyVTa4CYk7ri9Ic1XvhSwVIO0Gd9KpHQHNre0E4",94,287,288,575,49.91
"PikaGirl","rs1JjTIqpJeX5Re0bu5DrxEycezbrP9EEHD3ciR5M3Ij_zNMOrru_R6SBg",1,269,270,539,49.91
"rachet00","uxbFH_Fgpd0lmpK-KJThevx_0oP2KR2z9gU9kpkNSUHiAQM",24,281,282,563,49.91
"Hide on 7SHAI","vO-nfUP6LbwtNLEp4_garV7E6wGih5DLF5B7Wf3kH0VipbM",138,264,265,529,49.91
"pooopy1","9fnlm30FPXRhMEQdbMGAWs1Ut1J2mWuFIfWI-8yrzSAGMJ_o",96,291,292,583,49.91
"Arrogant","74lk7H0w8fyw2y9gSv9w6eBzq9TeZJIZ0nJ3EHpoaQmBwls",277,260,261,521,49.90
"MY TOP LOST GG","xk3U-y7Q5tsHvw3i0tqr7UVAB663JZQzxwlX0YpNuxUKylfC",103,509,511,1020,49.90
"8-Jul","c9rqojY8uc0niCdJtKMp3ObVINTo63oZwPQLJnkqlSja",92,256,257,513,49.90
"ChannyBoyy","zDj-zwWkY3FW5OJtQ5PM1DTMAN1n8g3OMOS-gzS_w9OK3Uo",145,257,258,515,49.90
"Natilla","KsC670krp8_En7JXgaKdYzBta-vK-afn6CmQQmRM-pwo86cjbVDV4TOhBA",34,243,244,487,49.90
"D4ndy God ","XEO6j4u32UHHkSNckmdmVaLSY29a-Qd_0bVCjLThacTNawE",1,233,234,467,49.89
"ArcticBird","VRmf0mWLXuo9W8KJL9UJv3eCwKa7t9bk9L3m3cOZaFv4x34",26,226,227,453,49.89
"Friendly Psycho","20gGETpwGLzKuM8JIJz0jic5xcQNmmWLIcEUimRYhYvjUVQ",16,457,459,916,49.89
"Garrett","c-o9tiPkQlAgrW-9Y6adiqFnXawJFzPNUfGFtlrlSMBmmO8",28,222,223,445,49.89
"xLazarus","Mq9YTE1vhyvOC_8sgott1NMmblIHXJGeX8D_Q9lGlLk2_7eRu9JsTivpFw",33,236,237,473,49.89
"I meow for daddy","IJC7IC8rNuHkaqi_WgOVq5jZb593d34g1X23J2I5ESlG19M",85,211,212,423,49.88
"gyu123987","LshCBGV57SXzXQKbaDJ9zmqaQq54UbWOGnW4ov421ztuwCc",123,416,418,834,49.88
"MEMEME670","fC5xKuB0IFRbMz4K28mIvJIe-w_-iRGy8MF-k7tyP3t8",13,377,379,756,49.87
"UnIess","IBWMEkPJyWj5zUBO4KYiZIAROFXH022HuMss4NBKNswGYIo",22,194,195,389,49.87
"CupGin","0f-waEgt8wAoqHQMTj1Gsg8WmXDub-6GRb6KrigTw8FUsm0",182,558,561,1119,49.87
"Jugö","KrUvSeV-NLe9TOJrf6fxAqqGRJ4H_sHTEWMQC3n9kazdFs4",135,195,196,391,49.87
"Fizz QWQ","pzyReJWSY0ngClrT4cSyctgpVIDgamBuxuHkaPek01VKSnk",16,182,183,365,49.86
"1032009","rwZEUUGnPszACzxcUwPOMyX8UoXsVMGUgbc7Kbm3kHBKgsU",131,165,166,331,49.85
"needyhenry","KFLEmUnNI1jP2bPNdFN16QjUD_0lsXvArmePtsnAreHpCts",136,661,665,1326,49.85
"i 1ue","pPkmD1yX6JnHTBsgD0Sb6PJZJNa1-bQ6hukm4bjYwnGuhDyI",173,311,313,624,49.84
"SHM Apu","YQx4AD5FCaKLKvUKpNM2MEoZMg9OJnxLrm_xfe8yWkVVFHc",58,462,465,927,49.84
"antownknee","8UyLxvD318_p3KqY1tCHueQMtwQUofn1vqfkhuAInlWFIdk",102,153,154,307,49.84
"heaven is online","DuU9-gjPsCi_vJBaoex2B14h8lrxVbYZA_rMFKGWt-ZxaSg",372,153,154,307,49.84
"Saknom","iiPoapBQcLBDw1p7CYLf4QrkG0fnQn-mwXOf9J3yYLABgP4",24,150,151,301,49.83
"MENTAL ATHLETE","6WkWY2nzwenJBXSqdH84Z5OgGa2LkOt7c3t7N046dShZQNQ",12,449,452,901,49.83
"Dvein In","h6sCEr5Gf5IayWDdhp73BvhZC5ALa6Zm8yW09QZhvS0Ngyc",87,562,566,1128,49.82
"Chapapii","nJzvyq1oK42-Awb-neYrBv85GorI7xTpgu-DbxwlVpKb-zRNSp7TJLcDWA",193,284,286,570,49.82
"legands","QH6rgpKbgR964KpyS3IJuDhENM92E61YXtVvFw0Bx3mf11I",111,416,419,835,49.82
"poor seasoning","AbJUf0VhgICEjH4vUkDppk2gZ-t4rBm5NC4VRyzkbhkHeFQ",28,142,143,285,49.82
"EpicFighter","e5V1sc2sCWaq7RRD_Xyj8OfQnhurDDxoicGyU3jWqqKJARI",31,408,411,819,49.82
"Setoo Kaiba","hwuECUMvJO_kRupIx-b8-c2xxSSNPtQjm2V0EcfPU-cfEIg",303,665,670,1335,49.81
"I am Agro","iwdOE6Uk3sNqgux5p45VM8AIZpliBPGMA_pgQWaBzrrnHPQ",1,134,135,269,49.81
"AJOSU","I7t1RwRKBE582XnRkoHgwcgzLgUtmy8O9FsmwEEv9JnLdz0",47,262,264,526,49.81
"Nantou no Asura","04SMna2wLEb6T2_BAn5vjAPcaIJM0Pdfvl4SlI6b1giwQvfN",31,269,271,540,49.81
"Mentalll","ZK3Ns2rAyfTSpda2B23-JxHg6ajyZZPqNMOe8pYO6zihajs",78,672,677,1349,49.81
"tsunami3d","recLoBZrgyRKRwMZfFCzWq-BuPTe5boJVgfY07Q1BMwob2ss",68,251,253,504,49.80
"jolol","0BtTZlcd25vELIekLMQ7pLvJo710AgWMMAICieCzcpwLB4A",10,122,123,245,49.80
"Invitrix","ycdHgAVFXjQr9ezTTRVcmAxMqPjyA1Wcm9DASflMrnF-cUg",86,380,383,763,49.80
"Joelini","QvZarkSelKHk09gL9689Vghr1ti2WkJRawLTp8RPKqQB0tg",47,123,124,247,49.80
"Art","w2N9f7SHeXWF_9Ne-inr6MVgpt6yAGEmx8ksGzwHSf7Tg44",40,363,366,729,49.79
"ainoi","oFZsKXbcAWuUeZ5OvBVwAlnVfXt2F3q-98X95Ym-vJqBqjU",179,121,122,243,49.79
"Michael Shaft","_BaaY6ux0EjFU9sLLCpFRNTtJ35XAkQIJisFQNDdax3C_OR6",177,231,233,464,49.78
"80Sheeps","uxR7FqWtxzIXeDSN4Lvc_iVzntNAzXcGx8OIofFpU86El-0",0,906,914,1820,49.78
"Shortley","_YvorGv-nhby8v_oSOVvMbERiYmqow3GDrfMoOMeclY6camd",84,458,462,920,49.78
"XHJ","kmm-S11BsERc9iw_kPxIBbfhg4mHMGrtK5vihjdi3HngeITdJ00TeaSjAQ",4,449,453,902,49.78
"Lancê","A2rQpar5sKHdNKX_alsuIHWFbt-ylBHlVLfCcz-wotWTgWo",15,340,343,683,49.78
"IM FKN AESTHETIC","GbQlth_XEDE1c9doGy_qVapFyHAPV9ins_L95QR0jrGSxusp",10,220,222,442,49.77
"LifeWater","qhF8R8BWDZMLmhEadPBHeEoXXPf7mMvIHi3ivLUXRpHJtkA",18,214,216,430,49.77
"Ogawa","IkRIEI63mVcXrhCDTx9VE_jcrPWaokw4gOMwv9V4f8FGRvo",8,325,328,653,49.77
"DIg Striker","VVwpmUsNl6HeTzAejn5NporroolahixH4uF_RFa1mRQsc64",95,324,327,651,49.77
"SorryMyßad","wfIva-Il3Ns0yv8m0gO82tAimXl5_pVAHysor_M0ZVyBnpw",76,106,107,213,49.77
"LA Huyle","VQP9-ZcyWhvHANmbE9Scp4tsVbXoUrYYrE7zpXK1-QvpAJOtD8MwyVkQEg",0,322,325,647,49.77
"Nunu Main","Uo5msWw_HoIi7rKbT-5_twgpg1UW6TPXGe5NE0oECiTHNGBD",142,430,434,864,49.77
"Zaun Holo","wSdp6sDNU2H7sJQh-qjWfhr0wcREbLBOZ-MLTXlynIg_nPMH",50,306,309,615,49.76
"SoftReps","0hcQVPyMTewcTbhIbv4aoklnDjtNhKOKWp5ROV_Y9L-RBiQ",93,102,103,205,49.76
"Sneewo","5p401HMxG6tfbsT4J1oPWLh04sWtDYIL65HI-vnWn0mjyffQ",0,309,312,621,49.76
"Styazu","_aV6Llz4R_Vifgqu9CdtjbfmAkPi4pSRzyK_eul_12WT8pU",52,498,503,1001,49.75
"Dregonaut","VrORLngcQkQ2XZW5F2lO1BKs-HPzF1KUjjDg_BsqNY9loM4",59,700,707,1407,49.75
"LegendaryLaser","hXAgmqqaENkUdrvSPsGVyeuw-6rtFH2PalbTDVvL7LJL6ss",50,203,205,408,49.75
"cba just play","8ckeOkRWjqm__gVlL2MmyqKwkmNfEfApcA4eFa3VBIJzCmw",35,198,200,398,49.75
"2013","m-h8mm3mP3zeIoBUoQdUdxhyUJLRjOUOlWclfhfTFKLUbh9Z",93,192,194,386,49.74
"Aatrox","wJ6eazW6aW6LRx9hrc6DVw_FA9hAt5dEVloPa9Nt1UdO4xZO",118,284,287,571,49.74
"Autolykus","qqgrq66FGWcu2TBD5zwa2slV_AU2eQt8Vejk5zrZTcI1jaQ",154,1287,1301,2588,49.73
"I am Guts","PnPoaCQJwXO33JVuzUpGFNWGPFu4ECy3U2HxFXypp-R0oSxN",120,183,185,368,49.73
"ABCD","WbBcxGVxFpkTR4cl9V9c60nKsTKFgc8ONbtYwWOM2hUZqUo",20,91,92,183,49.73
"TTV chenchen53","y04AGw7auEuDMyMIHYnP-FmsgBurzCpBaH8SW-Mcj3DIDmD_",142,724,732,1456,49.73
"GO0B","CF-a8wQ3YHD0wuV8YZQn9rTUYDKoBzbVom7sMUycldLDN4w",99,182,184,366,49.73
"Romanium 1v9","LT4QbflJq1H-TsgwZiple3ElL_OY3qSiY5ygbdLmkEUZi5k",58,175,177,352,49.72
"sweetvictoree","CGx1nD-YeAU9x7y90bMN3cO3i9c6V2f5z7QWwrthyHJbmXw",73,439,444,883,49.72
"rzd","F6I8lQaibhAJWAcixRRioSmUL3ib986uTMub0G4ocPnHKK17",18,616,623,1239,49.72
"zYuutor","Z-8IupHfVBt3RE1GMFoScphlsxs5Yq6xAZuYYhSJCnoKPPk",62,632,639,1271,49.72
"antgameplayer","JDlQXHpH7ssmLWF9uwUSAoxtGo6E47VJvb-CdOAd65J_ZGk",73,179,181,360,49.72
"Who is TK","_YhNU2yka76kGPjWPfutg6GNc0mfBU3X5IPn0ZpIOeoTI9D1wCSNQXsENw",1,444,449,893,49.72
"ViciousDolphin","YJSJgATaRnsn1qQUhDbaKSiajP4Y2W013hJplxH_IROP0qs",110,170,172,342,49.71
"DomeThunder","B2Ph5wy9ANc6mhEJykERkG7UV2vofGyARBpWIg2u1xxb5a8",0,1024,1036,2060,49.71
"OSU Cyborg","w4oGGQTZ8Kv4nlXCMcKtzv2GtygBaHGTwz0D-SYj4PcXx1s",49,958,969,1927,49.71
"Fishing for Urf","8uHIFqgIw3ulfv0R0qVy_GvxrzLMnCwCxe3MSK7o9gxiVN0",89,595,602,1197,49.71
"LETSLlGHTITUP","DQlgqvoxHJkOZeJsY3y63WQyKJHDg0SuI8JaHw-DZhmutpc",0,83,84,167,49.70
"DaMimZ","inPhsz9rE39xU2B6XFjwuLHTcEYeu9ZZJgbHmPAyDMQOgbHo",0,333,337,670,49.70
"TheNuocMam","s2ceP3iOh_GGqpoXM6SevkJKfcL6ioLYMSVJ-5uTLnOk3kk",127,581,588,1169,49.70
"NDMay0","dy9CJFaVGbmxRX9r-6-Fi1W3xBuAvQEeQX4BxZ-XO5Cgl0Fy",17,725,734,1459,49.69
"Delete All","fKVJT8kynNeGC1ck9f-AnG7YaDPT53S1O_27y3g77z3VNPAo9uwQjfIGEA",0,560,567,1127,49.69
"The best Steve","kEDA7HugsvSaJDZ2jsA8kwluC54AhbBxn6FTndE7KYXmsDY",168,718,727,1445,49.69
"Caspian 9 ","N_wUoQfGjNV87Kga3ASDZ7tBMUm_W787JNWW5ApmtCIZR-U",197,322,326,648,49.69
"Yang Shàn Chu è","CDRD74tADL-WhpcUv_Orv3VQ6cfdYeodiVj9cg7H5nvviJg",30,701,710,1411,49.68
"Hello I am Chris","BUmNBqMuUVJSdPxdsv3LBEzChrSFgcVjxLHAC-f-cvJhsMg",96,392,397,789,49.68
"TSH Sariel","M0_5r4uBhU_voYbjY1IRahrONVhXzuPUqiACTG7NSOTHAo8",163,543,550,1093,49.68
"NaCl Tim","mSRrShxG4I5z254-wDOJ-mZe0pEEmgQ1pPH8dKowDHcWnC4",109,230,233,463,49.68
"super niuniu","26VH9Vb15vN8dX3xfwIPVDACb5-qNwrOXiNEUl9ClS0MHSA",106,302,306,608,49.67
"Onier99","jBbzKK13a6ldMu8sUNaWkJAkokHi0yLMHQ6hMLH96xnS6Nk",98,225,228,453,49.67
"wx rank1mandingo","dXadEoq7XEn1AuHybrHKBYQR4QlNKvulW_41tbhli_r1IoQ",271,229,232,461,49.67
"VoidOwl","HBvotF1ZfccEr8yZL3saZZztVcJkIJ_CruqqODAiuBTPvVU",124,146,148,294,49.66
"Pady","nhXvbNBMNdanhS8V-TH7NhwlH_moT2ElUSWv7mZ8mqFaT7k",31,142,144,286,49.65
"Kriffi","S1PyqMy89z8D03PzX3ATV0-RtnGhrz6hjcX9e7CyCbDD2rE",71,140,142,282,49.65
"ChampBl","0ifMv7IPtuAqmI4HqPXiIfh3WYpa5WddnvtAZ3122ajkYR4",91,356,361,717,49.65
"Aizo","Fv0MhAbUIlRYN_31tjwnzvClzSPaR5ZGkKGwVUEu88HZ7dc",210,353,358,711,49.65
"Alphanias","yzsi63BFdpDn9_pic9jmkYIcwXxDCJv-jp6navDIZAslg46z",102,287,291,578,49.65
"ysha","KHQ6tw1BXJ8nf-2AnwAFF2DtMpGjXXCWRG9hEsupvS8fz-k",0,139,141,280,49.64
"lerd jump puddle","gTlVTGp-RunoY9x2LstVBEsG1fI6mb-DZ7nwWbwUhPFqaI5m",98,137,139,276,49.64
"Shang Piao","KenCofHAYzFOE9M-LbSljWnL2xc-MVxNce_swuQkD1dxFqc",39,133,135,268,49.63
"6abenx9","xgOCJty9tgopT3HAnpx1AWV0ZOq5apSaRQTdNgXTRa_jbcEq",158,195,198,393,49.62
"TyChee","vLVkEv_snqH4AR6VXWxKVhSufpLnITzUW6fh8_ixsfizZ7U",449,451,458,909,49.61
"IlIlllIIIIIl","wE0wJR6GUV8bGDWyEc3F0xHr85DbDtRgAq-AqW-R1Ww9fAXxup6jhAlVRg",379,184,187,371,49.60
"Doojeeboy","dYnDUuHHhXK9-CvOEmfb8hicBY04Sv5a5LqFbSvT9J-pE0M",17,249,253,502,49.60
"Bertsicle","wrDJlHuSByiDi-dsUSB1o1_sh3CGk7j-8DEwxt4gt1UnvO4",1,499,507,1006,49.60
"Newk","e_dl1FtPUoNzFNr3bel5UNVxfLBXvqzdwB5d2p5r9m5IF0I",21,122,124,246,49.59
"fichdragon","HN0vw6msUavLHmJPJ3OOwVDGgJk3zYd4vlUk0g9bpQkMYbI",128,239,243,482,49.59
"SB game","zDOUofWEaKT1G__iDIVDA_TE3kX6rbWfyPPdGwhlyeio3e0",22,183,186,369,49.59
"DDOSS","Drft2FhGvspAs706rP4wN1pxWXCXI5iI14P4onJpcDTxIdc",166,475,483,958,49.58
"Proosia","z1bh26odGhvWgfe-Tkw3gnWJOv1Q0tiWQlGQ7RMM_Llu84E",71,692,704,1396,49.57
"Lyfedone","512czlY2Kw-TSX23xvLG3AbLFCsnpJhcdGQM0LVl-gikdLs",33,172,175,347,49.57
"NotSporks","HQQHXCTY41V59WSfNKfkFP_oFZnhL6t8_xhlcckh2cIbUjU",111,113,115,228,49.56
"Christopher1","wh1_0g38fIk23eiSK3zE3xOif9Ld5RhdxqZdmGPoBiDGu-Y",1,283,288,571,49.56
"Addle","UC5fH_L98Chc-6kLQRJVjRzA5DDFaeaMbqYNt7W_cHsu",52,279,284,563,49.56
"Cervix","0NV68hWCy5AuSU9D2OTPRA1-qfIukDOY4gLLUeigKuSkuKOa",0,56,57,113,49.56
"Mibalzich","sl4isdtmOPs2WL5wRd17Mykbwgt_cBVPvnGiYZuVPaanAMs",89,340,346,686,49.56
"Oltan","p2sUnnf-Gg3RV_u_U-85yfZpawmJ02j3aYrDGxpXvNIjCJHS",115,545,555,1100,49.55
"SkyTOKKI","hS_vmgw1ynCvMsEpvvbGXYYrhj-qlfRauZ3d0WM6K0nVNJU",129,164,167,331,49.55
"Doctor Doom","gbW5_l0a4Kx1Tqk9U4Uq9XTRBaILGnxrnTz8ZXAk7zA4ugU",40,330,336,666,49.55
"Camp that Bush","iLIKJ2l-mE_-pEnxfjNFXgvRIjL4iqGnPyhGH0mNaLxbSWc",32,443,451,894,49.55
"Exothy","t-Q20EhlCX0aH8Oli6vQUA3J2_hU68QCZC2tUG9pLh-d-dA",166,219,223,442,49.55
"Melynlas","QaicRoUPPGyEW_uRVy2gMiY-40fCxzw8RRJlFsCJfWt2RM0",97,218,222,440,49.55
"Bombzilla","xhEcj4suE7lAX4lIxHr0-MEzdz1VZGhUJh-STk2TWZoZNtU",99,313,319,632,49.53
"Sokiu","K9TCIH6F96D5vZDvUqDP2LfZ4GA4u4tBvxDzIbU7KICEkOc",17,362,369,731,49.52
"Elessar","V87OsXGE0iN2RVHhLSa33uHkWjIQIj96sg2zfe-1pUM63x0",18,51,52,103,49.51
"PieckPerformance","Sff-LfXHYRNxWYLHGVedtAbmth6Mfo0HEmrA7QJ9WMi1oOs",35,148,151,299,49.50
"MythicNJA","ngsPu9qDo7RIgckY005K3C7TcxZDK-ELfdvYRZcYZ6Mypk0",50,298,304,602,49.50
"Girlfriend","3RjcaoksIR0a25Dbr6Q9mo8TwCuPCYB7fZVVx01Cgj7T2t0",110,100,102,202,49.50
"woof dog girl","xNfhJirX8X8ZEBQ3r0ypZYwRsvK7qMcJtonNxguqlA1WT240snmC5-lmsw",186,145,148,293,49.49
"L Escape","t7mSxFupvCHkq8gY1_qajs_FUBRIIFspGX7_xwHP_hxbFxc",16,526,537,1063,49.48
"IceCreamAssassin","bgieTgXtk-p2zwy9LyuyEgtkYqxlQc8yEiJ3XWxKr9Ln-07qo3Hq3Erl7w",239,239,244,483,49.48
"DontBanYasuoPlz","6FNZHEOQd-SOh_aH9RE7VkKRv-bju8n2dBw_Ebgu35_PgaM",18,324,331,655,49.47
"HELLO RIN","KPYFFVGwsXxDkSx1ZkWj7-faE3-3KMkySn323pmO3kVHg1g",42,94,96,190,49.47
"handytaco","sVez-OJ8T9q3vR1Y0r8NQf8qxMJjeEcQ0dC5PXYWZd2M5jc",52,557,569,1126,49.47
"Sybr","T1jHgpxLnmEuSFc_t1b_DZIg3xkyk--p24GKAAeNolJ_sxo",400,179,183,362,49.45
"XTEARSTACKER69X","yKhJVGhODnibAVtcBjwgDvgS0iyEgfhuXaA-4c4EoJMnOsQU",156,136,139,275,49.45
"MalevolentTitan","IifPKbbNa9iNz2a17_wKLy-J53s_WxpjrjdKmEkg8DnzqRc",92,270,276,546,49.45
"Son2k1docthan","BroapPerva3vv7-QUehWk_NPHI1vp9JYYoNCoVV6yPZ7cq8",167,222,227,449,49.44
"Well play sir","42PCa8wv5uTNqFGJPSK5oyw_djHBWi532i5j0Ly7-jGFZEaq",365,130,133,263,49.43
"B1ackTiger AFu","hEKdb2uOGFz-KscIjs3jLPTRq3zSNGbb3Mbj_br6DlSQUag",67,130,133,263,49.43
"Mister Wubz ","gEvIYChPMJhRvXSIM38cO6JvAtevy8FRShXXg513iKOgd10",122,174,178,352,49.43
"SuperHuner","A_wmAGraWKch5J_8Y8rdqpbuCHfNfWasH9Z2gZVyENxAppE",35,131,134,265,49.43
"rqewwfqra","CV0y5cUGgYNM4-Si3Mt2HnNZbyk-6c6lThZkoBxyixVLuGU",155,174,178,352,49.43
"Iced Venti","188n2uuZp0rwMPVc7hXloRWTF4JPMMCM3ddVx21F1M8AgDc",83,364,373,737,49.39
"WHY PP HARD 808","fsQQuxfxKWOQMsK-txZnd9npV-V9CWSTErSYg0ShiR7yG1M",49,436,447,883,49.38
"gemi swift","v6HsgfWLmoAyKgt1WA_wZbb0RbyA_LkWSuC1p5NNmgSsX08",33,196,201,397,49.37
"Dolphine","U4VFxLkiYXLYW85-gl0RvKc0qFncvNnNLX3LRMgDxuQjO1k",36,78,80,158,49.37
"TwTvUrUncleSam","Yid9HoV3GcRr9c2U-SZE5d5520q2FcW0lHereuKG6ai8JDE",29,154,158,312,49.36
"Beginning","ObU0JvFygG6LSUMNWJpsK6lmGPBa68z2SK35eaHnGZBC9z8",17,271,278,549,49.36
"Pure9","bGmFf3STmbkEmJG7YdtLUl8zlOBl-m9kprabrkFbe7vVczc",25,151,155,306,49.35
"Sapfiros","9RYjA863iokN6jhnH-IBjsym6NXfkZCHswsWgBESvPUXeUM",57,410,421,831,49.34
"Dangerously","jy6c1RCoiHHpDPuzbARR7DeWS7v7px1m6JCiLvzHYD1cTtU",103,181,186,367,49.32
"DaBox","T00Vji5wfFHiDkS7OcUcHWuBzJ-ahQq0Q7-p-cNmO5mJ1bA",0,108,111,219,49.32
"MacroMage","RbpuxRiv-e67VjkByD0xzI_nweIECz7i5_Auze339ZsMEpI",20,255,262,517,49.32
"KillerUnit","Q2nXpwKjXCQqdKVLogvKJIGNFdaZ5pNOEJTly-NS-TnezuE",75,255,262,517,49.32
"l can do it","kLA1EU69Ar4J4fgBVO5aD-IO3AcKEUoI5hGnvNtJuHEqLv0",45,142,146,288,49.31
"BrolyNutSack734","mvvrcGBgqr_SrJowDijFsJUOVsQyis2zU-dLsPL0JgH7jEA",285,140,144,284,49.30
"Mr Davius","sZliQkltTxbSh-h9LuD5NkxHgHmYP2g_CdqT-dnU9c1q-A5EVpdimyF98Q",32,425,437,862,49.30
"DPS METERED","gczFbJCUEvhGaTMLJtDxn__v4w8_96yjBQ36j44hae6VfU4",1,175,180,355,49.30
"Capiche","yOai0tIf0B7-zAOyMn4epgvEBBFPnyHJOJuwAqkTQMnvyQM",1,278,286,564,49.29
"Ronfaure","NVuNQnqvy00Cb3SnYqeRzOwlOLD8_1MPm1a_7_ril3UGxFs",0,235,242,477,49.27
"Haru De Wanai","YAmF3JLKmREy9e8iSgaIKFsQ6lwlMDAAaCmj5lnfJtwXz8E",72,335,345,680,49.26
"PR3TZEL","3EvpfKfYRA-B7bMz0U8yBoWnKilKzlvkabszM7B_lxCDdcU",1,167,172,339,49.26
"Insaneblast","UbKedZR_58aR5TlolFI0I80xhpCNepSGZALm9PYn0FkVhsk",16,292,301,593,49.24
"KnicNicks","Aem4IddObwl4gJvNK7_C0vGuj4OLN5ze-ifyd0cn5egJ9uM",16,255,263,518,49.23
"ABCDEFKWEAKSIDE","5LQuMWtIFNSTxx2xWiTTkc2gWHiGoAF1glnPH9KKsoBYK5k",33,193,199,392,49.23
"Zayno","SLSEw2K6cOfjE6AMS2hCo_BiI-lWanby7v6IKtCki2-dq9M",15,250,258,508,49.21
"Le Khan","AOxSTufxzQMoCEVA-TUcqQupANgPVf4mU0sFOmX70BMcZoM",154,241,249,490,49.18
"Desmiano","nQnFCccYol64AspeCwIOpIEkA74QFmhcPz6HfOOG1rF1zYQ",1,181,187,368,49.18
"qiong","ZK3m9semjVZdg226W8lrWDOnQm7CIgMVBX1yI_LsogDUifw",219,88,91,179,49.16
"ibarakura","YsBOEntfDt4H6RIX0FBDpKZMcArwIa-MdUwB2mIQhMh8fs0",202,58,60,118,49.15
"Hydrra","Mx_Dz6fZrvWpxJV1dwh6jbH8nGEJG4m08-ZNFSrT7pD0vS0",120,174,180,354,49.15
"fuji mountt","joZu6s04DEB9HirMmzPAqFt0-p5qtltgeeAz9TeOrf5pJcY",250,311,322,633,49.13
"Sunsets","xlB9WyHwhGRc8I6ojb5xY9_MAhFiQorGwiaGXykDtHIgsN9C",2,196,203,399,49.12
"CDamon","cIkhxiZdJ0zp3b41cbOeB0SMYmnmXA2QVY4idYLKMrKdvLI",17,302,313,615,49.11
"ÃñÐý","niCX2--AedAswcM1k6PXdVZI8wpgoIrInxRwtOdSfcp45Rk",213,138,143,281,49.11
"sdfgbdslg","WqtxzNWt6jtuhj0T1jdBhFM6k-MxU-u02ow0CAJhBywH",59,165,171,336,49.11
"Evolves","WSgQBMxQBZFh3KzWvXktTh7ocTv5MuNuUuVGkGmuE_doy9-b",41,136,141,277,49.10
"Slurps","LrcjdNmsG27Uqxx4RFR3iJEcx9-B9AmMCe4THAiH9y7oMU0",49,137,142,279,49.10
"Can Win N0 Need","bXTP4uGiKdWZ3V725lVjtL6NTW2P2K6i4RArRdULa-VcEao",1,133,138,271,49.08
"Random Player","qLa7KebdOCDe45GHN1igUT4wrmHZ8FIig9YIdMA1FwAU_5A",44,133,138,271,49.08
"wo nb bù","FcRODJp90qT3enrSVESs7MGwUhn3P6rtwodAQbj39jR2z-2o",2,213,221,434,49.08
"A Gamer Girl","xWTdHYXMuXAYRU-URvB4ix2Nam9_E__FfMsml0nRGqBABww",0,186,193,379,49.08
"F8 Tributo","LyHcuXNFudD0jnY6GUjspixsjzHx8aBSdneMWgQhfeQJnmk",132,105,109,214,49.07
"Maulface","NUviSndwowT73EXWEXjDCHXd-Qh9KQV7IJd194fzgQMUjPY",34,76,79,155,49.03
"Love Aileen","0utJvPfIGtyWTg5UjgyjB0Z-y76fTQMUMIugBTqNktxgxtBA0RGascPGDA",160,100,104,204,49.02
"Khatab","qC7D1LJ_bp_V3c8KFvRaTQJ_e9VcQy3YLDHbux5wHe9dHSg",82,226,235,461,49.02
"Viagra Vinegar","QdF_G6Lumqb8omFEmhdoR2vV3rVIeU4DCdokgNSaRxPdPRk",40,199,207,406,49.01
"Rabadon","hPzIWzw3auF5CHs5MK4UeEiz4PPUjK29YYl4g2oez9Kae2A",1,174,181,355,49.01
"Le July","YH2IrWc99-gRzTUsXPkVXTJAPA1ErBCQ6TAfcrnBOya_naKWzZ9_wQUvDQ",67,148,154,302,49.01
"Levitate","Ta7-a9Emx1CqHRjizObJCf-rNmaU9fiS9PXtdmaSFciJmLs",107,121,126,247,48.99
"Zhu Zai Zai","xU-pcoR-FoeqXDIsQ_ORop2pTIRbFkEHG1mk6-FPYB4Tmz4",15,144,150,294,48.98
"BronzeVg","FO9v_MBBfmQlC_mMpIlAb3OPsWMXsTrQSC1GDHawLfjKx5o",92,168,175,343,48.98
"Construct 00","YYH23kfM_NzMEwMMEcp-QkA90TYMx3JAWCdS6Sx_GwsjCx5I",57,356,371,727,48.97
"midlanez","S_8dR8t1pPJxkOKV1pchNbpX74sUnHedSYK6K-nPCm0s-0s",46,93,97,190,48.95
"Mouten","h-U6GbA-3TPYVzlMryyxvfxt4F9H35NxSdcKvD6m4LHJxPQ",66,69,72,141,48.94
"Nightness","IwsIO9y7mZFbNwk_XxIyABZ8LYBD1H3xKcHnQj1f1bNqRizY",101,67,70,137,48.91
"X2JIE","pK9Nnhb0rxS0O-JzTegxLUTcpmrrb8liHM52KEdFtcPDmOE",0,224,234,458,48.91
"Nazorio","IiJzSTBM7RmuhqPk_uRnyOqVOe31_V3JEdbzZGxnFf4i64I",74,88,92,180,48.89
"SoldMyCow4Sona","Lo_75EmjLiXJ4SD-S_tZ6gShoYx-NCgYwVoIxFnwk01ANOQ",177,131,137,268,48.88
"Mr Thot","ltpE_Ek7zb02YZ3OKYXgs_4p903fY-4_Yn2WsTPUM8QfbQo",71,127,133,260,48.85
"losing it a bit","_50xxqNBkPEy09-ky9LuWAC9pBqfbLoI62gbGDBMmvrcfBE",116,126,132,258,48.84
"bloody yandere","uIx6blf-lubhNPqZVSFHv3geXdXA1PC993bJwARqX44yALEG",99,147,154,301,48.84
"Synicull","ulDcdKzhcjofu9BWIqInn578Rm0Yg-B0-1zwr8svlcNddZiRyV9Fob48CA",29,187,196,383,48.83
"basalist","pjbIF-KFYEKWtxRmOh7Qvke3s_Zq6ThjOYYr-3wiGRrZXq8",80,125,131,256,48.83
"Prove Urself","6vPzN0AbZqD43Xpirtsn4jzf5o40IwdUSsuzjqejLG6-jNM",212,241,253,494,48.79
"rovex4","u8ubL5rMuBWq_Fx0b9JvQ4mfUS4zFenEw9dLsDf_42cZnoE",95,120,126,246,48.78
"yi ge da shi ge","7IIP5XfhVg7JMaDzLXcN-M41QcZsC3mNJA74ghU4QfnJyNa5",15,157,165,322,48.76
"One Hit Your Zed","fT8AO7xSDBjra8kFX_6qF3OFyO-MauSgSGwiwrFXljNb0EA",37,272,286,558,48.75
"ExpeIIiarmus","uuhZj-zrmFCgWKLSYlNQkyXvHw10KBDh_wwlQGHSKKB8THw",0,134,141,275,48.73
"Öliverªce","Sz8AEopLr7AoSfFSJeFnYK_ZennP-OApkaZgvFtj5qyGM3s",26,134,141,275,48.73
"UnDankDragon","AUSZk2HAfaZ2FAYtf3FTQv9JxhvzP2BEzldmXyolBgJV8q0",174,190,200,390,48.72
"niko44","33qoDT8Yxnky766gYgyJaVNIT6aymzeTQoDfu3AdaxtI",35,151,159,310,48.71
"Saint SpoonKing","ItE3Kuyi_UVjYHzU44MEY2oJjwtWssuG0IORM5ijN_I57R0CpkSdt7fxCQ",1,36,38,74,48.65
"pprr","DMe41w_x9U7s8mRZrd4LF5_A71TxwI7KdQIRN2CM3EmDqBE",77,87,92,179,48.60
"Meowing Cat","OM_qRNF8eAB_gb2YyFn2c172NYpnJbLNBEmaW6IczKk4REM",146,102,108,210,48.57
"EleJiggle","3xDpJL8XsQJddHBI0wb3g7aefyJKD7oyer2c5gS9cTbKcF8",4,133,141,274,48.54
"ﬂay","LbdvMUG_iZGbsDfyKthtXXtcsA5JA8PqF3PAn8-xk287S6o",0,181,192,373,48.53
"Noodlz","dyAU3A1orE-jN_IJda0WWHoOaTYsvwyGpD9J_oFwUDxDyoU",21,98,104,202,48.51
"young1","vv-snOfNi2HosICDHpgrEar_fxbcpzhsu9l20IBNCun50NMdofdShe9HAQ",174,239,254,493,48.48
"pleasedontbark","BcARhbLuyAyJ7HF0Fz5h0qjh7bA3B-XTOXGWRVbVwmhrR3h1",0,63,67,130,48.46
"Trisend33","6oltDhV1LBp1VR3Ig4A8RyUAWnOg4KKzDU-WKJx5AqyZ2Z01",1,203,216,419,48.45
"sigyetaeyeob","qBhcWUiv0qmCzueKPoLAWk94soiE4W91goKPp9y0SH-xqfA9507qqB6RtA",174,209,223,432,48.38
"Icelandic Hero","PONGiVTvuD574i03qArhPzbddVYgJYj-exYOoCuKnt90Nb8",247,253,270,523,48.37
"kyoungminyy","oQc9TzswVCleMWHVE8FmOXvQsVvpHsCpS_XZ323B2mChnd0",1,89,95,184,48.37
"US 101","dhoR3jtSbgkYrIQ57JbtOPdlhkZBudk2dgtlWoBfySTOC-s",21,44,47,91,48.35
"Fauntleroy","7_bPmyB2lKVFXYXHZVSskR4uTbg6xi3lOaRiqz5o-PX86jE",85,175,187,362,48.34
"Liuuuuuuuuu","EdGvT2W8EDxn5C--9V1xEXR-t5SHeF0Dn0JRay3gwcniOh4",231,192,206,398,48.24
"plez","IipSG8OJ2-CcwhcCLxi-R59grVWEHkqTBvGPf30bAm2IdDo",23,235,253,488,48.16
"4rch","XH6SxBKP2bNvjTQZZhPmpDfQEl32ZbmsyBPgOpLLK1Li73E",5,129,139,268,48.13
"Ribitey","n72zUEuit-l9Hd-z0NRGIA7PLSOb67LjyGVr1tCqPvQBWgM",28,116,125,241,48.13
"sugohaesseo","WWLLjJcvWxyWGQTvWhS7iY2YBxNCFHnguyebuE4PhRzQMxY",43,76,82,158,48.10
"Everglowing","VfT78vEZmAh6f6Ilwx8MUesjNaVE7zcP293yYwqT8Ggf1Cv1",28,112,121,233,48.07
"sharpen my knife","JrRrLcFbCuU25jPRXYIz0vmPKH1Dz8oVtJm3HhoZRqbLz18",203,235,254,489,48.06
"Godlike Footsies","f7xoP_pMKNvrMbR3pA3YWOb5iG7V8bbhu0OBDL1gHWvYxYU",18,122,132,254,48.03
"Coinflip Sim","XB6oXIU3AZ6LZqxN8dmT0LL-mfrOR1nljV3Am46kWX1gEBg",4,169,183,352,48.01
"Espion","Z_RHgGJgvbXsunKWbg8Bp04Yop0oX1kUQ6ZRRlhqcPZJY8Y",19,83,90,173,47.98
"MrLemonnn","NYvp3AyAiSqQcrROayPAv2EBVRyGYnWW1QtZxHF1Yx9iIUdX9svbWO3MRg",129,115,125,240,47.92
"Save Bees","2zQFKZ_l--a8Zn-QY0Xwre1ceQNHsk46JPEJSmgxRlDNp-Y",52,79,86,165,47.88
"FIick","fPqVhffqd94drzMbN5yGhbgLia104ge-90pa37ftK_B-UIo",31,110,120,230,47.83
"Hibito","oC9dSWIfZ-Y_cI2l0zkZRXfoewT9w9uOvJW6MHYB7vVEyNU",1,55,60,115,47.83
"Phrxshn","2dGARk8bLxwhFUJMuYBXxGBmHgW8V_dkD1Hd54IhC8jq",1,110,120,230,47.83
"ParaIyzed","jLGIvTEZ2JizJHUMVfkR2Sj0apGF6Sxt19fSfy6Z_CXaSwdIs2HEwnwD3w",252,98,107,205,47.80
"Lovepaopao QvQ","ZYtIhaTzpUTIJeLpGz0ONmgLVivDzO5j3Zo7sfeoMMUxo4Y",268,86,94,180,47.78
"kegemos","-6mJaJzu0oe5J5GO3umDTUzpgjm3uiPFoQaufQSZg9KJ",0,139,153,292,47.60
"NYF5","c3zAUa71Tj0zCjMkJ4RCxUOPCgzAMV92OTXHwD-DXWtcLtw",1,102,113,215,47.44
"TOP XDXDXD","fnUMXcCLwDRyUfw7sK0O_9zyiDBemeJiSra67F1ZNHZLrlc",98,247,274,521,47.41
"Tiancheng Nan","2O-9AqO0zNfaC14qZMGkHzHTxC-rUiXjnEbCuITZaOjnKlxH",229,108,120,228,47.37
"Keusios","hg226YfuWZFgfasm6T796pNYSMBnYgKJF5dp3K13RdzhSZA",17,98,109,207,47.34
"EDG Khàn","5-9-PSVwHwbqFb7khUL9sjrb-rulx7hETMsOcWb3CspaP2w",44,53,59,112,47.32
"peewee1","8BZxFGKMRYle_W9rfThMI3jGsZMPfk_5D2y4EaVyqXRAS1U",44,103,115,218,47.25
"Angelica","TXFyS1FTV9Fqas01vAS3lpidUmkferyIetywkZaKPX6zTIU",0,130,147,277,46.93
"Thanos","3njCXPFSds0kZDJMJg-4ak3LJJwyfMgUJchLUKK_3YO_7w6F",0,91,103,194,46.91
